			
1001 Rabbit Tales	Bugs Bunny, Daffy Duck, Sylvester, Tweetie, Porky Pig, Mel Blanc		Animation
101 Dalmations		Walt Disney	Cartoon
1776			Musical
1984	John Hurt, Richard Burton	George Orwell	Sci Fi
2001: A Space Amnesty	Leslie Nielson		Comedy
2001:A Space Odyssey		Stanley Kubrick, Arthur C. Clarke	Sci Fi
2010		Arthur C. Clarke	Sci Fi
21	Kevin Spacey, Laurence Fishburne, Kate Bosworth		Drama, Las Vegas Card Counting
21 Grams	Sean Penn		Drama, Heart Failure
21 Jump Street	Johan Hall, Ice Cube		Police Comedy
25th Hour	Ed Norton, Barry Pepper, Philip Seymour Hoffman, Rosario Dawson, Brian Cox	Spike Lee	Drama, Russian Mob/Drugs/Growing up in NY
3:10 to Yuma	Russell Crowe, Christian Bale, Ben Foster		Western
40 year old virgin			Comedy
8.5		Frederico Fellini	Foreign, Movie Director
8MM	Nicholas Cage, Joaquin Phoenix, Dennis Hopper	Joel Schumacher	Mystery, S/M Killers
Abbott & Costello Are Lost in Alaska	Bud Abbott, Lou Costello		Comedy
Abbott & Costello Go to Mars	Abbott & Costello		Comedy
Abbott & Costello In Society	Abbott & Costello		Comedy
Abbott & Costello Meet Invisible Man	Abbott & Costello		Comedy
Abbott & Costello Meet the Mummy	Abbott & Costello		Comedy
Abbott and Costello: The Christmas Show	Bud Abbott, Lou Costello		Variety Show
About Last Night	Rob Lowe, Jim Belushi, Demi Moore, Elizabeth Perkins		Drama, Romance
Above the Law	Steven Seagal		Drug Dealers
Absolute Power	Clint Eastwood, Gene Hackman		Mystery, Politics
Abyss	Ed Harris	Steven Spielberg	SciFi, Sea
Ace Ventura - Pet Detective	Jim Carey		Comedy
Ace Ventura - When Nature Calls	Jim Carey		Comedy
Aces and Eights	Ernhest Borgnine, William Atherton		Western
Addams Family			Comedy
Addicted to Love	Matthew Broderick, Meg Ryan, Jean Stapleton, Kelly Preston		Romantic Comedy
Adventures of Pluto Nash	Eddie Murphy, Rosario Dawson, Peter Boyle, Randy Quaid, Alec Baldwin		SciFi Comedy
After Hours	Teri Garr, Rosanna Arquette		Drama, Murder in Soho
After Worlds Collide			SciFi
Against All Odds	Jeff Bridges, Alex Karras, James Woods		 Football
Against The Ropes	Meg Ryan		Drama, Boxing
Air America	Robert Downey, Jr.		Comedy, Airforce
Air Force One	Harrison Ford		Drama, Airforce & Presidents
Airplane	Peter Graves, Leslie Neilson, Robert Stack, Kareem Abdul Jabbar, Julie Hagerty		Comedy
Airport 75			Comedy
Alamo	John Wayne, Richard Boone, Frankie Avalon, Laurance Harvey, Richard Widmark	John Wayne	Western
Alice			
Alice Doesn't Live Here Anymore			Drama, Romance
Alice in Wonderland	Johnny Depp, Anne Hathaway	Tim Burton	Fantasy
Alien	Sigourney Weaver		SciFi
Alien Nation	James Caan		SciFi
Aliens	Sigourney Weaver		SciFi
Aliens of The Deep		James Cameron	Documentary, Ocean/Deep Space Life
All Hands On Deck	Barbara Eden		Comedy, Navy
All of Me	Steve Martin, Lily Tomlin		Comedy
All That Jazz	Richard Scheider		Musical, Drama
All the King's Men	Sean Penn, Jude Law, James Gandolfini, Anthony Hopkins, Kate Winslett, Kathy Baker		Political Thriller
All The Presidents Men	Robert Redford, Dustin Hoffman		Drama, President Nixon
All the Pretty Horses	Matt Damon, Penelope Cruz, Bruce Dern	Billy Bob Thornton	Western
All the Right Moves	Tom Cruise		Football
Along Came a Spider	Morgan Freeman		Mystery
Along Came Polly	Ben Stillar, Jennifer Aniston, Hank Azaria, Debra Messing		Romantic Comedy
Alphaville			SciFi
Alvarez Kelly	William Holden, Richard Widmark		Western
Always	Richard Dreyfuss	Steven Spielberg	Drama, Romance
Amatuer	John Huston		Drama, CIA
American	George Clooney		Drama, Hitmen and Weapons Dealers in Eur
American Autobahn			Mafia
American Beauty	Kevin Spacey, Annette Bening, Chris Cooper, Jason Robards		Drama, disfunctional families
American Flyers			Drama, Bicycle Racing
American Gangster	Denzel Washington, Russell Crowe, Cuba Gooding Jr.	Ridley Scott	Drama, Black Mafia
American Gigolo	Richard Gere, Lauren Hutton		Mystery
American Grafitti	Charles Martin Smith, Martin Sheen, Penney Marshall, Cindy Williams, Ron Howard, Harrison Ford		Drama, 60s
American Hot Wax	Chubby Checker, Jay Leno, Fran Drescher		Musical, 50s
American Strays	Luke Perry, Eric Roberts, Jennifer Tilly, John Savage		Weird people in the rural west
American Yakuza	Virgo Mortenson, Ryo Ishibashi, Michael Nouri	Frank Cappello	Japanese Mafia, Mafia, FBI
America's Sweethearts	John Cusack, Catherine Zeta-Jones,Billy Crystal, Julia Roberts, Hank Azzaria, Christopher Walken		Romantic Comedy
Amistad	Matthew Moccanaughey, Morgan Freeman, David Paymer, Anthony Hopkins, Anna Paquin, Djimon Hansou	Steven Spielburg	Legal Drama, 1839 Slavery/Murder
An Unfinished Life	Robert Redford, Jennifer Lopez, Morgan Freeman		Family Drama, Wyoming Ranch
Analyze That	Robert De Niro, Billy Crystal, Lisa Kudrow		Comedy, Mafia and Shrink
Analyze This	Robert De Niro, Billy Crystal, Lisa Kudrow		Comedy, Mafia
And Starring Pancho Villa as Himself	Antonio Banderas, Alan Arkin		Drama, Mexican Revolution
Anderson Tapes			SciFi
Andromeda Strain			SciFi, Michael Crichton
Angel			Drama, Hookers
Anger Management	Jack Nicholson, Adam Sandler		Comedy
Animal Crackers	Marx Brothers, Margaret Dumont		Comedy
Animal House	John Belushi, Randy Quaid		Comedy
Anna and The King	Jodie Foster		Drama, Siamese Emperor:kingdom, war
Annapolis	James Franco		Drama, Naval Academy
Annie Hall	Woody Allen, Diane Keaton		Comedy
Another 48 Hours	Eddie Murphy, Nick Nolte		 Cops
Another Stakeout	Emilio Estevez, Richard Dreyfuss, Rosie O'Donnell		Police Drama
Any Given Sunday	Al Pacino, Cameron Diaz, LL Cool J, James Woods, Matthew Modine, Jamie Foxx, Ann-Margret, Lauren Holly, Jim Brown, Charleton Heston	Oliver Stone	Football Drama
Apache Drums	John Wayne		Western
Apocalypto		Mel Gibson	Drama, Mayan Civilization
Apocolypse Now Redux	Martin Sheen, Marlon Brando, Robert Duvall, Larry Fishburne, Harrison Ford, Dennis Hopper	Francis Ford Coppola	War, Vietnam
Apollo 13	Tom Hanks, Kevin Bacon, Ed Harris	Ron Howard	SciFi
Appaloosa	Ed Harris, Vitto Morgensen, Renee Zelweger	Ed Harris	Western
Aristocats			Cartoon, Disney
Around the World in 80 Days	David Niven		Musical
Arrival	Charlie Sheen, Ron Silver, Richard Schiff		Sci Fi
Arsenic & Old Lace	Tony Curtis		Mystery, Detective
Artificial Intelligence	Jude Law, William Hurt, Haley Osman	Stanley Kubrick, Steven Spielberg	Sci Fi
Assasination Tango	Robert Duvall	Robert Duvall, Frances Ford Coppola	Drama, hit man and family man and dancing
At Close Range			
At The Circus	Marx Brothers		Comedy
Austin Powers	Mike Myers, Elizabeth Hurley, Raquel Welch, Mimi Rogers		Comedy, Time Travel and Secret Agents
Australia	Nicole Kidman, Hugh Jackman		Western, Romantic Drama, WWII
Avalon			Drama, Jewish Immigrants
Avatar	Sigourney Weaver, Michelle Rodriguez	James Cameron	Sci Fi
Avengers	Ralph Fiennes, Uma Thurman, Sean Connery		Comic Book--From TV Series
Aviator	Leonardo DeCaprio, Alec Baldwin, Alan Alda, Cathy Blanchett, Kate Beckansale	Martin Scorcese	Drama, Howard Hughes Biography
Awake	Terrance Howard, Jessica Alba		Murder Mystery, Anesthesia
Awakenings	Robin Williams, Robert De Niro		Drama, Handicapped People
BaadAaassss			Drama, Black movie makers
Babel	Brad Pitt, Kate Blanchett		Drama, Atempted murder/three continents
Bachelor Party	Tom Hanks		Comedy
Back to School	Rodney Dangerfield		Comedy
Back to the Future	Michael J. Fox, Lea Thompson, Christopher Lloyd	Robert Zemeckis	SciFi Comedy
Back to the Future II	Michael J. Fox, Christopher Lloyd		SciFi Comedy
Back to the Future, III	Michael J. Fox, Christopher Lloyd, Lea Thomson, Mary Steenburgen	Robert Zemeckis, Steven Spielberg	Comedy, Sci Fi Western
Backlash			
Bad Boys	Sean Penn, Ally Sheedy		Drama, Juvenile prison
Bad Company	Jeff Bridges		Western
Bad Influence	Rob Lowe, James Spader		Drama, Suspense
Bad News Bears	Walter Matthau		 Baseball
Bananas	Woody Allen, Lauren Lasser, Howard Cosell	Woody Allen	Comedy, 3rd World Coup
Bang The Drum Slowly	Robert De Niro, Vincent Gardenia, Michael Moriarty		Drama, Baseball & Cancer
Bank Job	Jason Statham		Crime Drama, biggest bank heist ever
Bank Shot	George C. Scott		Comedy
Barefoot Executive	Kurt Russell		Disney, Chimpanzee, Comedy
Basic Instinct	Sharon Stone, Michael Douglas		Mystery
Batman	Michael Keaton, Kim Basinger, Jack Nicholson		Joker, 1989 Version
Batman	Adam West, Burt Ward, Cesar Romero, Frank Gorshin, Burgess Merideth		Version 1966
Batman Begins	Christian Bale, Katie Holmes, MIchael Caine		Comic Book
Batman Forever	Val Kilmer, Jim Carey, Nicole Kidman, Chris O'Donnel		Riddler
Batman Returns	Michael Keaton, Burgess Meredith		Penguin
Beach	Leonardo DeCaprio		Drama, Island cult
Beach Blanket Bingo	Frankie Avalon, Annette Funicello, Don Rickles, Buster Keaton, Paul Lynde, Linda Evans, Jody McCrae,  Donna Flora, Bob Harvey, Harvey Lembeck	William Asher	Beach comedy, musical
Beach Party	Frankie Avalon, Annette Funicello, Bob Cummings, Harvey Lembeck, Murray Amsterdam, Eva Six, Vincent Price		Musical Comedy
Beautiful Girls	Matt Dillon, Timothy Hutton, Lauren Holly		Romance
Beautiful Mind	Russell Crowe, Ed Harris	Ron Howard	Drama, Schizophrenic and Genius
Beauty and the Beast			Cartoon, Disney
Bedazzled	Brendan Fraser, Elizabeth Hurley		Comedy:  The devil
Bedknobs and Broomsticks			Disney, Cartoon
Being John Malkovich	John Malkovich, John Cusack, Cameron Diaz, Orson Bean, Mary Kay Place, Sean Penn	Spike Johnz	Fantasy
Bellboy	Jerry Lewis, Milton Berle	Jerry Lewis	Comedy
Ben Hur			Roman Empire
Beneath the Planet of the Apes			SciFi
Benny & Joon	Johnny Depp		Romance, Retarded People
Best Little Whore House in Texas	Burt Reynolds, Dolly Parton, Jim Nabors, Dom Deluise		Comedy, Musical
Best of Everything			
Better Off Dead	John Cusack		Romantic Comedy
Beverly Hills Cop	Eddie Murphy, Judge Reinhold		Comedy, Drama, Cops
Beverly Hills Cop II	Eddie Murphy, Judge Reinhold		Comedy, Drama, Cops
Beverly Hills Cop III	Eddie Murphy, Judge Reinhold		Comedy, Drama, Cops
Beyond the Sea	Kevin Spacey, John Goodman		Musical Drama, Bobby Darin Story
Big Bus			Comedy
Big Chill	Glenn Close, Jo Beth Williams, Mary Kay Place, Kevin Kline, William Hurt, Jeff Goldblum, Tom Berenger, Meg Tilly	Laurence Kasdan	Drama, Reunion
Big Fish	Billy Cuddup, Albert Finney, Jessica Lange, Ewan MacGregor, Danny DeVito	Tim Burton	Fantasy Drama
Big Jake	John Wayne, Richard Boone, Maureen O'Hara, Chris Mitchem, Patrick Wayne		Western
Big Mouth	Jerry Lewis		Comedy
Big Sleep	Robert Mitchum		Detective, Sam Spade, Raymond Chandler
Big Store	Marx Brothers, Margaret Dumont		Comedy
Big Trouble			
Billy Bathgate	Dustin Hoffman, Bruce Willis, Stephen Hill		Gangster
Billy Jack			Street Fighting
Billy Two Hats			Western
Biloxi Blues	Matthew Broderick, Christopher Walken		Comedy, Neil Simon, WWII
Birds		Alfred Hitchcock	Drama
Black Bird			Comedy, Detective
Black Rain	Michael Douglas, Andy Garcia		Japanese Mafia
Black Sheep	David Spade, Chris Farley		Comedy
Black Sunday	Bruce Dern, Sophia Loren		Football
BladeRunner	Harrison Ford, Sean Young, Darryl Hannah, M. Emmitt Smith	Ridley Scott	Sci Fi
Blazing Saddles	Cleon Little, Slim Pickens	Mel Brooks	Western, Comedy
Blindfold: Acts of Obsession	Shannon Doherty, Judd Nelson		Suspense
Blood Diamond	Leonardo DeCaprio, Martin Sheen, Jennifer Connally		Drama, Africa Civil War
Blood Simple	Frances MacDormand, John Getz, Dan Hedaya	Joel Coen	Drama, Murder
Blood Work	Clint Eastwood, Jeff Daniels, Angelica Huston	Clint Eastwood	Drama, Detective
Blow	Johnny Depp, Penelope Cruz, Ray Liotta		Cocaine Dealers
Blowout	John Travolta		Action, Mystery
BlowUo	David Cummings, Vanessa Redgrave, Sara Miles		Drama, Photographer and Murder
Blue City	Judd Nelson, Ally Sheedy		Action
Blue Steel	Jamie Lee Curtis		Cops
Blue Thunder	Robert Mitchum		Racing
Blues Brothers	John Belushi, Dan Aykroyd		Comedy, Musical
Bobby	William H Macy, Sharon Stone, Heather Graham, Emilio Estevez, Demi Moore, Nick Cannon, Christian Slater, Freddy Rodriguez, Anthony Hopkins, Laurence Fishburne, Harry Belafonte, Martin Sheen, Helen Hunt,Freddy Rodriguez, Lindsay Lohan, Elijah Wood	Emilio Estevez	RFK Assasination
Bobby Jones:  Stroke of Genius	Jim Caviezel, Claire Forlani, Malcolm McDowell		Golf, Bobby Jones Biography
Body of Evidence			
Bodyguard	Whitney Houston, Kevin Costner	Lawrence Kasdan	Drama, Crazy music fans
Bonnie & Clyde	Warren Beatty, Faye Dunaway		Bank Robbers
Boomerang	Eddie Murphy		Comedy, Office Work
Borat			Comedy, Muslim coming to America
Bordertown	Jennifer Lopez, Martin Sheen		Drama, NAFTA/Factory Slavery
Born Free			Drama
Born Losers			Billy Jack, Street Fighting
Bound	Jennifer Tilly		Drama, Mafia & Con Man
Bourne Identity	Matt Damon	Doug Liman	CIA, amnesia
Bourne Supremacy	Matt Damon, Brian Cox, Julia Stiles, Joan Allen		Action CIA
Boy Ten Feet Tall			Drama, Children
Boys From Brazil			Drama, Hitler & Cloning
Boyz in the Hood	Cuba Gooding, Jr.; Lawrence Fishburne		Gangster
Brainstorm	Christopher Walken, Louise Fletcher, Natalie Wood, Cliff Robertson		SciFi, brainwashing
Brannigan	John Wayne		Cops
Brass Bottle	Tony Randall		Comedy
Breakfast at Tiffany's	George Peppard		Romance, Drama
Breakfast Club	Judd Nelson, Emilio Estevez, Anthony Michael Hall, Molly Ringwald, Ally Sheedy		Drama, High School
Breakheart Pass	Charles Bronson		Western, Mystery, Alistair MacLean
Breakin'			Dancing, Drama
Breaking Away	David Stern		Action
Breaking Training	Walter Matthau, Jodie Foster		Bad News Bears, Baseball
Breaking Up			
Breakout	Charles Bronson		Drama
Breakup	Jennifer Aniston, Vince Vaughn, Ann Margret		Romantic comedy
Breathless	Richard Gere		Drama
Brewster McCloud			
Brewster Millions	Gene Wilder, Richard Pryor		Comedy
Bright Lights, Big City	Michael J. Fox, Phoebe Cates, Keifer Sutherland		Drama
Brighton Beach Memoirs			Neil Simon, Comedy
Brink's Job			
Broadcast News	William Hurt, Albert Brooks, Holly Hunter, Joan Cusak, John Cusak		Romantic Drama
Broken Arrow	John Travolta		Action
Broken Lance	Richard Widmark		Western
Bronx is Burning	Oliver Platt, Daniel Sunjata, John Torturra		Baseball Drama, 1977 Yankees
Bronx Tale	Robert De Niro	Robert De Niro	Drama, Gangsters
Bruce Almighty	Jim Carrey, Jennifer Aniston, Morgan Freeman, Catherine Bell		Comedy
Bugs Bunny:  Hare Extraordinnaire	Bugs Bunny, Daffy Duck, Yosemite Sam, Mel Blanc	Chuck Jones	Animation
Bugsy	Warren Beatty, Annette Bening		Gangster
Bull Durham	Kevin Costner, Susan Sarandon		Baseball
Bullett	Steve McQueen		Cops
Burglars			Drama
Burning Hills			
Buster & Billie			Romance, Drama
Busting	Elliot Gould, Robert Blake		Cops
Butch Cassidy  & The Sundance Kid	Robert Redford, Paul Newman, Katherine Ross	George Roy HIll	Western
Cable Guy	Jim Carrey, Matthew Broderick, George Segal, Ben Stiller, Owen Wilson	Ben Stiller	Comedy
Caddyshack	Bill Murray, Rodney Dangerfield, Chevy Chase		Comedy, Golf
Cadence	Charley Sheen, Martin Sheen		Drama, Military
Cadillac Man	Robin Williams		Comedy, Car Salesman
Cahill: US Marshall	John Wayne, George Kennedy		Western
California Split	George Segal	Robert Altman	Gambling
Call Me:  Rise and Fall of Heidi Fleiss	Jamie Lynn Discala, Saul Rubinek, Corbin Bernson		Drama, Prostitution
Capitalism: A Love Story		Michael Moore	Documentary
Capone			Mafia
Capote	Philip Seymour Hoffmann, Chris Cooper		Drama, Writer/Death Row
Capricorn One	James Brolin, Sam Waterston, OJ Sompson, Hal Holbrook, Brenda Vacarro, Teli Savales, Elliot Gould	Peter Hyams	Sci Fi, Adventure
Captain Eddie			Airplanes, Eddie Rickenbacher
Capturing the Friedmans			Documentary:  Child Molestation
Career Opportunities	Robert Downey, Jr., Jennifer Connelly		Comedy, Growing up
Carlito's Way	Al Pacino		Drama, Mafia
Caroline at Midnight	Judd Nelson, Mia Sara, Tim Daly		Drama, sex & drugs & murder
Carrie	Timothy Hutton, Sissy Spacek	Brain De Palma	Horror
Cars	Owen Wilson, Bonnie Hunt, Paul Newman		Animation
Casey's Shadow	Walter Matthau		Drama, Horse Racing
Casino	Sharon Stone, Robert De Niro, Joe Pesci, Don Rickles, James Woods	Martin Scorcese	Drama, Mafia
Casino Royale	Daniel Craig, Judi Dench	Albert E. Broccoli	James Bond
Casino Royale	Woody Allen, David Niven		James Bond Spoof
Casper	Christine Ricci, Eric Idle, Bill Pullman, Cathy Moriarty		Cartoon
Cassandra Crossing	OJ Simpson		Train Robbery
CastAway	Tom Hanks, Helen Hunt	Robert Zemeckis	Adventure, Pacific Island
Casual Sex	Lea Thompson, Victoria Jackson, Andrew Dice Clay, Mary Gross		Romantic comedy
Casualties of War	Sean Penn, Michael J. Fox, John C. Reilly, John Leguzzamo, 	Brian De Palma	Vietnam War/Rape/Murder
Cat Ballou	Jane Fonda, Nat King Cole, Lee Marvin		Western Musical
Catch Me If You Can	Leonardo DiCaprio, Tom Hanks, Martin Sheen, Christopher Walken	Steven Spielberg	Drama, Con Artist and the FBI
Catfish			Documentary, Facebook liar
Cedar House Rules	Michael Caine, Charleze Theron		Drama, Orphanage
Chamber	Chris O'Donnel, Gene Hackman, Faye Dunaway	John Grisham	Legal Drama
Changing Lanes	Ben Affleck, Samuel L. Jackson		Drama, Law
Chapter Two			Comedy, Neil Simon
Charley Varrick	Walter Matthau, Joe Don Baker		Bank Robbery
Charlie Wilson's War	Tom Hanks, Phillip Seymour Hoffmann	Mike Nichols	Afghanistan War:1980
Chase	Charlie Sheen, Kathryn Swanson		Comedy, Car chase
Chato's Land	Charles Bronson		Western
Cheech and Chong's Next Movie	Cheech and Chong		Comedy, Music
Cheyenne Social Club	Shirley Jones, Jimmy Stewart		Western, Hookers
Chicago	Richard Gere, Catherine Zeta Jones, Renee Zellweger, Lucy Liu		Musical, Death Row
Children of the Damned			Horror
China Moon	Ed Harris, Madeline Stowe, Beneicio Del Toro		Mystery
China Syndrome	Jack Lemmon, Jane Fonda		Drama, Nuclear Power Plant
Chinatown	Jack Nicholson, Faye Dunaway, Roman Polanski	Roman Polanski	Detective, JJ Geddes
Chisolm	John Wayne		Western
Chocolat	Juliette Penoche, Carrie Anne Moss, Judi Dench, Johnny Depp		Drama, religion conflicts/chocolate shop
Choirboys			Comedy, Police
Choose Me			Drama, Dating
Chorus Line	Michael Douglas		Musical
CIA Exiled	William Petersen, George C. Scott		Drama, CIA and South African Terrorists
Cinderfella	Jerry Lewis		Comedy
Citizens Kane	Orson Wells		Drama
City Hall	Al Pacino		Drama
City of Angels	Meg Ryan, Nichola Cage		Romantic Drama, Angels
City of Industry	Steven Dorff, Harvey Keitel, Timothy Hutton, Lucy Liu		Jewel Thieves/Doublecrossing
City Slickers	Billy Crystal		Comedy, Western
Civil Action	John Travolta, William H. Macy, Robert Duvall, John Lithgow		Civil Lawsuit, true story
Class	Andrew McCarthy, Rob Lowe, Jacqueline Bissett, Cliff Robertson, John Cusack, Joan Cusack		Romantic Comedy
Class Action	Gene Hackman, Mary Elizabeth MastroAntonio		Drama, Law
Class Reunion			Comedy,National Lampoon
Client	Tommy Lee Jones, Susan Sarandon	John Grisholm	Crime, Law
Clockers	Harvey Keitel		Drug Dealers
Clockwork Orange		Stanley Kubrick	Science Fiction
Close Encounters of the Third Kind	Richard Dreyfuss, Teri Garr	Steven Spielberg	Science Fiction
Closer	Jude Law, Julia Roberts, Natalie Portman, Clive Owens	Mike Nichols	Romantic Drama
Clue	Tim Curry, Martin Mull, Lesley Ann Romanoff, Madelaine Kahn		Mystery based on board game
Cobb	Tommy Lee Jones		Drama, Baseball
Cocktail	Tom Cruise		Drama, Carribean
Cocoanuts	Marx Brothers, Margaret Dumont		Comedy
Cocoon	Brain Dennehy, Hugh Cronin, Steven Guttenberg, Tanya Welch	Ron Howard	Science Fiction
Code	Morgan Freeman, Antonio Banderas, Robert Forster, Radha Mitchell	Mimi Leder	Jewel Thieves, Russian Mafia
Code 46	Tim Robbins, Samantha Morton		Sci Fi
Cold Mountain	Jude Law, Nicole Kidman, Renee Zellweger, Donald Sutherland		Civil War
Cold Turkey			Drama, Quit Smoking
Collateral	Tom Cruise, Jamie Foxx	Michael Mann	Drama, Hit Man
Collateral Damage	Arnold Shwarzeneggar		Action, Columbia terrorists
Color Purple	Whoopi Goldberg, Oprah Winfrey, Danny Glover, Laurence Fishburne	Steven Spielberg	Drama, racism
Columbiana			Action - Columbia drug dealers and hitmen
Coming to America	Eddie Murphy, Arsenio Hall, James Earl Jones		Comedy
Commancheros	John Wayne, Lee Marvin		Western
Compromising Positions	Susan Sarandon		Comedy, Dentist
Computer Wore Tennis Shoes	Kurt Russell		Comedy, Disney
Confessions of a Call Girl		Lawrence Page	Drama, Call Girl
Confessions of a Dangerous Mind	Sam Rockwell, George Clooney, Drew Barrymore, Julia Roberts, Bob Eubanks, Chuck Barris	George Clooney	Drama, Chuck Barris Story
Confessions of a go go girl	Corbin Bernsen		Drama, Catholic stripper
Conspiracy Theory	Mel Gibson, Julia Roberts, Patrick Stewart		Drama, Govt Assasins
Constant Gardener	Ralph Fiennes		Political Pharmaceutical African Thriller
Contact	Jodie Foster, Matthew McConaughey, James Woods, Angela Bassett, Tom Skerritt, John Hurt	Robert Zemeckis, Carl Sagan	Sci Fi
Conversation	Gene Hackman	Francis Ford Coppola	Drama, Wiretapping
Copland	Ray Liotta, Harvey Keitel, Sylvester Stallone, Robert De Niro		Police & Mafia Drama
Copy Cat			Murder Mystery
Corrupted Minds	Aida Munoz, Mark Brock, Hugh Gall, Derek Denham, Dale Murphy, Cordell Gibbs, Vince Orlando, Eva Wilson	Brian Lawrence	Drama, Crime/Poverty in Detroit
CoupDeVille			Comedy, Fighting Brothers
Cover Girl			Drama
Cowboys	John Wayne		Western
Crash	Brendon Fraser, Sandra Bullock, Ryan Phillipe, Matt Dillon, Terrence Howard, Don Cheadle, Jennifer Esposito		Drama, Police and Racism
Crazy Heart	Jeff Bridges, Robert Duvall		Romantic Drama, alcoholic country singer
Crazy joe	Peter Boyle		Drama, Mafia
Crimes and Misdemeanors	Jerry Auerbach	Woody Allen	Murder, Affairs
Crimson Tide	Densel Washington, Gene Hackman		Drama, Submarine
Crocodile Dundee	Paul Hogan		Comedy, Australia
Crouching Tiger Hidden Dragon			Drama, Authentic China with subtitles
Crying Game	Forrest Whitaker		Drama, Irish Republican Army
Curious Case of Benjamin Button	Brad Pitt, Cate Blanchett	David Flincher	Drama, Reverse Aging
D.O.A.	Dennis Quaid, Meg Ryan		Murder Mystery
Dallas Cowboy Cheerleaders	Bucky Dent		
Damnation Alley	George Peppard		Drama, Nuclear War
Dances With Wolves	Kevin Costner	Kevin Costner	Western
Dangerous Minds	Michelle Pfeiffer		Drama, Inner City High School
Dark Knight	Gary Oldman, Christian Bale, Heath Ledger, Michael Caine, Morgan Freeman, Aaron Eckert		Batman
Dark Knight Rises	Christian Bale, Anne Hathaway, Morgan Freeman, Michael Caine, Matthew Modine, Gary Oldman		Batman
Darkman			Comic Book
Dave	Kevin Kline		Comedy, President
Day After			
Day at The Races	Marx Brothers, Maureen O'Sullivan, Margaret Dumont	Sam Wood	Comedy
Day of the Dolphin	George C. Scott		Drama, Dolphins
Day of the Wolves			Drama, Burglary
Day the Earth Stood Still			Science Fiction
Days of Thunder	Tom Cruise, Patrick Swayze		Drama, Auto Racing
Dead Again			Suspense
Dead Men Don't Wear Plaid	Steve Martin, Rachel Ward		Comedy
Dead Poets Society	Robin Williams		Drama, Boys School
Dead Pool	Clint Eastwood		Dirty Harry
Death on the Nile	David Niven, Peter Ustinov		Hercule Poirot Mystery by Agatha Christie
Death Wish	Charles Bronson		Drama, Vigilante
Death Wish 4	Charles Bronson		Drama, Vigilante
Death Wish II	Chrales Bronson, Jill Ireland, Vincent Gardenia, J D Cannon, Laurence Fishburne	Michael Winner	Drama, Vigilante
Deep	Robert Shaw, Jacqueline Bisset		Drama, Scuba Diving
Deep Throat	Linda Lovelace, Harry Reems		
DeerHunter	Robert De Niro, Christopher Walken, John Cazale, Meryl Streep, John Savage	MIchael Cimino	Drama, Vietnam/Friends/Depression
Defenseless	Barbara Hershey		Drama, Law
Deliberate Intent	Timothy Hutton		Law Drama
Delicate Delinquent	Jerry Lewis		Comedy
Deliverance	Jon Voight, Burt Reynolds		Drama, Wilderness
Delta Heat	Anthony Edwards, Lance Henrikson		Police Drama
Departed	Mark Wahlberg, Matt Damon, Leonardo Decaprio, Martin Sheen, Alec Baldwin, Jack Nicholson	Martin Scorcese	Drama, Rhode Island Mafia & cops
Derailed	Clive Owen, Jennifer Aniston		Suspense, Scams and Fatal Attraction
Desk Set	Katherine Hepburn, Spencer Tracy		Computers in the Office
Desperately Seeking Susan	Rosanna Arquette, Madonna		Comedy, Hippies
Deuce Bigalow: Male Gigolo	Rob Schneider		Comedy
Devil's Advocate	Al Pacino, Keanu Reeves, Charlize Theron, Jeffrey Jones		Romantic Drama, Lawyers and The Devil
Diamond Men	Donnie Wahlberg		Drama, Unemployment/Salesmen/Hookers
Diamonds are Forever	Sean Connery	Brocolli & Saltzman	James Bond
Dick Tracy	Warren Beatty, Madonna, Dustin Hoffman, Al Pacino		
Die Another Day	Pierce Brosnan, Halle Barry, Judi Dench, John Cleese	Albert Broccoli	James Bond
Die Hard	Bruce Willis		Disaster Thriller
Die Hard: Die Harder	Bruce Willis		Disaster Thriller
Die Hard: With a Vengeance	Bruce Willis		Disaster Thriller
Diner	Steve Guttenberg, Daniel Stern, Kevin Bacon, Timothy Daly, Ellen Barken, Mickey Rourke, MIchael Tucker	Barry Levinson	Drama, College Boys
Dirty Dancing	Patrick Swayze, Jennifer Grey, Jerry Auerbach		Drama, Dancing vacation catskills
Dirty Dancing, Havana Nights	Patrick Swayze		Drama, Dancing in Cuba
Dirty Harry	Clint Eastwood, Andy Robinson	Don Siegel	Police Drama
Dirty Pretty Things			Mystery
Dirty Rotten Scoundrels	Michael Caine		Comedy
Disclosure	Demi Moore, Michael Douglas, Donald Sutherland		Drama, Sexual Harassment, Michael Crichton
Disorderly Orderly	Jerry Lewis		Comedy
Disorganized Crime			Comedy
Distant Trumpet			
Distinguished Gentleman	Eddie Murphy		Comedy, Politics
District 9			SciFi
Doc Hollywood	Michael J. Fox		Comedy
Dog Day Afternoon	Al Pacino		Drama, Bank Robbery
Dogma	Ben Affleck, Matt Damon, Bud Cort, Linda Flourentino		Comedy, Angels & Devils
Dogs of War	Christopher Walken, Tom Berenger, Jo Beth Williams	Frederick Forsyth	Drama, CIA and Govt. Coup
Don Juan DeMarco	Johnny Depp, Marlon Brando		Romantic Drama
Donnie Brasko	Johnny Depp, Al Pacino		NY Mafia, FBI
Down With Love	Ewen MacGregor, Renee Zellweger		Romantic Comedy
Dr. DoLittle	Rex Harrison, Robert Attenborough		Musical, Animal doctor and communicator
Dr. No	Sean Connery, Ursula Andress, Joseph Wiseman, Jack Lord	Broccoli & Saltzman	James Bond
Dracula	Gary Oldman, Keanu Reeves, Anthony Hopkins, Winona Ryder		Horror
Dragnet	Jack Webb, Ben Alexander, Richard Boone, Ann Robinson	Jack Webb	Crime Drama
Dragnet	Season 1, Disk 1.  Jack Webb, Harry Morgan		Police Drama
Dragnet	Dan Aykroyd, Tom Hanks, Harry Morgan, Ricardo Montalban		
Dragon: Bruce Lee Story			Drama, Karate
Dreamgirls	Beyonce Knowles, Jennifer Hudson, Jamie Foxx, Danny Glover, Eddie Murphy, John Lithgow		Musical, cut throat music industry
Drug Wars: Camarena Story	Craig T. Nelson, Treat Williams, Bernicio Del Toro	Michael Mann	Drama, drugs & DEA in Mexico
Duchess & Dirtwater Fox	George Segal, Goldie Hawn		Comedy
Ducksoup	Marx Brothers		Comedy
Dumb and Dumber	Jim Carey, Jeff Daniels		Comedy
Dune	Kyle McLaughlin, Max Von Sydow, Linda Hunt, Patrick Stewart		Science Fiction
Eagle Has Landed			WW II
Earthquake	Charleton Heston		Disaster
Ed Wood	Johnny Depp, Martin Landau, Bill Murray, Patricia Arquette, Sarah Jessica Parker, Max Casalla	Tim Burton	True Story:  Worst Filmmaker
Eddie & The Cruisers	Michael Pare, Tom Berenger		Drama, Rock N Roll
Eddie and The Cruisers, Part II	Michael Pare, Larry King, Bo Diddly		Musical Drama
Edge	Anthony Hopkins, Alec Baldwin, Elle McPherson		Alaska Adventure
Edward Scissorhands	Johnny Depp, Alan Arkin		Science Fiction
Eiger Sanction	Clint Eastwood, George Kennedy		Mystery, Spies, Mtn. Climbing
Eight Heads in a Duffel Bag	Joe Pesci, David Spade, Kristi Swanson, Dyan Cannon, George Hamilton		Comedy, Hit Man
Eight Men Out			Drama, Baseball, Black Sox Scandal
Eight Mile	Eminem, Kim Basinger, Brittany Murphy		Drama, Detroit ghettos and rap music
El Dorado	John Wayne		Western
Embryo	Rock Hudson		Science Fiction
Empire Strikes Back	Marc Hamill, Harrison Ford, Carrie Fisher	George Lucas	Science Fiction, Star Wars
Empire: Two Worlds Collide	John Leguizamo, Denise Richards		Drama, drug dealers/white collar scams
Empty Cradle	Kate Jackson		Baby Kidnapping
Enchanted	Patrick Dempsey, Susan Sarandon		Musical/Comedy, fairy tale spoof
Encino Man	Brendan Fraser, Pauly Shore, Megan Ward		Comedy, High School/Caveman
End of Days	Arnold Schwarzeneggar		Suspense, Cops & Religious Killings
Endangered Species			
Enemy Mine			Science Fiction
Enemy of The State	Will Smith, Lisa Bonet, Gene Hackman, Jon Voight		Govt Assasins, gangsters
Enforcer	Clint Eastwood		Drama, Cops, Dirty Harry
Entrapment	Sean Connery, Catherine Zeta Jones		Drama, Professional thieves
Erin Brokovich	Julia Roberts		Law Drama
Errand Boy	Jerry Lewis, Brian Denlevy	Jerry Lewis	Comedy, Hollywood Errand Boy
Escape From Alcatraz	Clint Eastwood		Prizon Escape Drama
Escape From New York	Kurt Russell, John Van Cleef, Ernest Borgnine, Isaac Hayes, Harry Dean Stanton	John Carpenter	Sci Fi
ET	Drew Barrymore	Steven Spielberg	Science Fiction
Eternal Sunshine of The Spotless Mind	Jim Carey, Kate Winslet, Mark Ruffalo, Kirsten Dunst		Romantic Drama, Twilight Zone
Every Which Way but Loose	Clint Eastwood, Sandra Locke		Street Fighting
Every Which Way You Can 	Clint Eastwood,  Sandra Locke		Street Fighting, Chimpanzee
Everybody's All American	Dennis Quiad, Timothy Hutton		Drama, Football, Romance
Everything you always wanted to Know About Sex	Woody Allen, Burt Reynolds, Tony Randall, Diane Keaton, Gene Wilder	Woody Allen	Comedy
Evil That Men Do			
Executive Action			JFK Assasination
Exit to Eden	Dan Aykroyd, Rosie O'Donnell		Comedy, S & M
Exorcist	Linda Blair		Horror
F/X	Brian Dennehy		Drama, Mafia, Special Effects
Face on the Milk Carton	Jill Clayburgh		Drama, kidnapping and family life
Factotum	Matt Dillon, Lili Taylor, Marisa Tomei		Drama, Alcoholic writer
Fahrenheit 451			Science Fiction, Ray Bradbury
Fahrenheit 911		Michael Moore	Documentary, Bush Presidency
Fair Game	Cindy Crawford, William Baldwin		Action, Russian Mafia
Fair Game	Sean Penn, Naomi Watts, Sam Shephard		Drama, CIA Agent leak (Valerie Plame)
Falcon and The Snowman	Sean Penn, Timothy Hutton		Drama, Spies
Falling Down	Michael Douglas		Drama, Unemployment
Fame	Irene Cara		Drama, Musical, Dance School
Family Plot		Alfred Hitchcock	Comedy
Fantasia 2000			Disney Cartoon
Fantasy Island	Season 1, Disk 1.  Ricardo Montalban, Herver Villechaise		
Fantasy Island	Season 1, Disk 2.  Ricardo Montalban, Herver Villechaise		
Fantasy Island	Season 1, Disk 3		
Fantasy Island	Season 1, Disk 4		
Far side of Jericho			Western
Farewell, My Lovely	Robert Mitchum		Detective Philip Marlowe by Raymond Chandler
Fargo	Francis McDermott, William H. Macy		True story about Wife Kidnapping
Fast and The Furious	Van Diesel		Drama, drag racing
Fast Times at Ridgmont High	Sean Penn, Jennifer Jason Leigh, Phoebe Cates		Comedy, High School
Fatal Attraction	Michael Douglas, Anne Archer, Glenn Close		Suspense, One night stand
Father of The Bride	Steve Martin		Comedy
Father of The Bride II	Steve Martin, Martin Short		Comedy
Favorite Deadly Sins	Andrew Dice Clay, Joe Montegna, Denis Leary	Denis Leary, National Lampoon	Comedy, Emotions and pitfalls
FBI Story	James Stewart, Vera Miles		Drama & Documentary
Fear City	Tom Berenger, Billy Dee Williams		Drama, Strip Joint
Ferris Beuller's Day Off	Matthew Broderick, Jennifer Gray, Charlie Sheen	John Hughes	Comedy
Fever Pitch	Drew Barrymore, JoBeth Williams, James Sikking		Baseball Comedy
Fiddler On The Roof	Zero Mostel		Drama, Musical, Russia, AntiSemitism
Field of Dreams	Kevin Costner, James Earl Jones, Ray Liotta		Drama, Baseball
Fifteen Minutes	Robert De Niro, Edward Burns		Police Melodrama, Insane Killer
Fifth Element	Bruce Willis, Luke Perry		Sci Fi
Fifty-Two Pickup	Roy Schneider, James Woods		Mafia, Action, x-rated movies
Fight Club	Edward Norton, Brad Pitt		Drama, Sociopathic Fighters/Terrorists
Final Analysis	Kim Basinger		Drama, Fatal Attraction
Finding Nemo	Albert Brooks, Ellen DeGeneras, Elizabeth Perkins, William DaFoe		Disney Cartoon
Finding Neverland	Johnny Depp, Julie Christie, Kate Winslet		British Family Drama
Firefox	Clint Eastwood		Russia, Aviation
Firewall	Harrison Ford		Drama, Kidnapping and Bank Robbery
Firm	Tom Cruise, Ed Harris, Gene Hackman, Wilford Brimsley		Drama, Lawyers & Mafia.  John Grisholm
First Family	Bob Newhart, Gilda Radnor		Comedy, White House
Fish Called Wanda	Jamie Lee Curtis, Kevin Kline		Comedy
Five Card Stud	Dean Martin, Robert Mitchum, Roddy McDowell		Western
Flaming Feathers	Barbara Rush, Sterling Hayden		Western
Flamingo Kid	Richard Crenna, Matt Dillon, Janet Jones		Gambling, Summer Vacation
Flashdance	Jennifer Beals		Romance, dancing
Flatliners	Julia Roberts, Kevin Bacon, Keifer Sutherland, Oliver Platt, William Baldwin	Joel Schumacher	Psychodrama, medical students, afterlife
Flintstones	John Goodman, Elizabeth Perkins, Rosie O'Donnel, Rick Moranis, Kyle McLaughlin		Comedy
Flintstones:  Viva Rock Vegas	Stephen Baldwin, Joan Collins		Fantasy
FM	Martin Mull		Drama, Radio Station
Fools Rush In	Matthew Perry		Romantic Comedy
Footloose	Lori Singer, Kevin Bacon, Christopher Penn		Dancing
For a Few Dollars More	Clint Eastwood		Western
For Love or Money	Michael J. Fox, Michael Tucker		Romantic comedy
For Pete's Sake	Barbara Steisand		Comedy
For The Love of The Game	Kevin Costner, Kelly Preston		Drama, romance, baseball
For Your Eyes Only	Roger Moore	Broccoli & Saltzman	James Bond
Forbidden Games			Detective, heavy sex 
Forbidden Planet			Science Fiction
Ford Fairlane	Andrew Dice Clay		Comedy
Forever Young			
Forgotten	Julianne Moore, Gary Sinise		Sci Fi Scary
Forrest Gump	Tom Hanks, Sally Fields	Robert Zemeckis	Drama, Retarded but successful
Forty Days & Forty Nights	Josh Hartnett, Mary Gross		Romantic comedy
Forty eight hours	Nick Nolte, Eddie Murphy		Cops, Action
Foul Play	George Segal, Goldie Hawn		Comedy
Four Weddings and a Funeral	Andie McDowell, Hugh Grant		Romantic comedy
Fourth Kind			Sci Fi
Fracture	Anthony Hopkins, Ryan Gosling		Legal Drama
Frankie & Johnnie	Al Pacino, Michelle Pfeiffer		Drama, Romance
Frantic	Harrison Ford		Drama, Hitchcock style
French Connection	Gene Hackman		Cops, Action, Drugs
French Connection II	Gene Hackman		Action, Cops, Drugs
French Kiss	Meg Ryan, Kevin Kline, Timothy Hutton		Comedy, Romance
Frenzy		Alfred Hitchcock	Mystery
Frequency	Dennis Quaid		Drama:  Ghosts, Fantasy
Friends With Benefits	Justin Timberlake, Woody Harrelson		Romantic Comedy
Frisco Kid	Gene Wilder, Harrison Ford	Robert Altman	Western, Orthodox Rabbi
From Russia With Love	Sean Connery	Broccoli & Saltzman	James Bond
Front Page	Jack Lemmon		Comedy, Neil Simon, 30s
Frost/Nixon	Sam Rockwell, Frank Langello. MIchael Sheen. Oliver Platt, Kevin Bacon	Ron Howard	Drama, Nixon/Frost interviews
Fugitive	Harrison Ford		Based on TV Series
Full Metal Jacket	Matthew Modine, Vincent D'Onofrio, Lee Ermey, John Stafford	Stanley Kubrick	Marines in the Vietnam War
Fun With Dick & Jane	George Segal, Goldie Hawn		Comedy
Fun With Dick & Jane	Jim Carrey, Alec Baldwin, Teo Leoni		Comedy, Corporate Scandals
Funny Girl	Barbara Steisand		Drama, Romance
FutureWorld	Peter Fonda		Science Fiction
Gambler	James Caan		Drama
Game	Michael Douglas, Sean Penn		Drama, Twilight Zone
Gang Wars			Like Crappy Home Movie
Gangs of New York	Daniel Day Lewis, Leonardo DeCaprio, Cameron Diaz	Martin Scorcese	Gangsters, 19th Century
Gator	Burt Reynolds		Action
Gauntlet	Clint Eastwood, Sondra Locke		Action
Geisha Boy	Jerry Lewis		Comedy
Get Shorty	John Travolta, Danny Devito		Comedy, Mafia
Getaway (1972)	Steve McQueen, Ali McGraw, Sally Struthers		Bank Robbery, Drama
Getaway (1993)	Alec Baldwin, Kim Basinger		Bank Robbery
Getting Gotti			Mafia don John Gotti
Ghost	Patrick Swayze, Demi Moore		Drama, Romance, Afterlife
Ghostbusters	Bill Murray, Sigourney Weaver, Rick Moranis		Comedy
GI Blues	Elvis Presley		Musical, GI's in Germany
Gingerbread Man	Robert Duvall, Robert Downey Jr., Darryl Hannah	Robert Altman, John Grisham	Law Drama, murder
Girl With the Dragon Tatoo	Daniel Craig, Rooney Mara, Christopher Plummer		Mystery
Gladiator	Russell Crowe, Connie Nielson, Joaquin Phoenix, Oliver Reed	Ridley Scott	Drama, Roman Empire
GlenGarry GlenRoss	Al Pacino, Kevin Spacey, Jack Lemmon, Alec Baldwin, Alan Arkin, Ed Harris, Jonathan Pryce	David Mamet	Drama, Sales
Glory	Matthew Broderick		Civil War
Go West	Marx Brothers, John Carroll, Diana Lewis		Comedy
Godfather	Al Pacino, Marlon Brando, James Caan, Diane Keaton, Robert Duvall	Francis Ford Coppola	Drama, Mafia
Godfather II	Al Pacino, Robert De Niro, Diane Keaton, Talia Shire, Robert Duvall, James Caan	Francis Ford Coppola, Written by Mario Puzo	Mafia
Godfather III	Al Pacino, Sophia Coppola, Diane Keaton, Talia Shire, Andy Garcia, Bridget Fonda, Joe Montegna	Francis Ford Coppola, Written by Mario Puzo	Mafia
Gods Must Be Crazy			Comedy
Gods Must be Crazy II			Adventure, Africa
Godzilla			Japanese Monster
Goin' South			
Golden Child	Eddie Murray		Comedy
Golden Child	Eddie Murphy		Comedy
GoldenEye	Pierce Brosnan	Broccoli and Saltzman	James Bond
GoldFinger	Sean Connery	Broccoli & Saltzman	James Bond, Oddjob
Gone Baby Gone	Casey Affleck, Michelle Monaghan, Ed Harris, Morgan Freeman, Jill Quinn, Amy Madigan	Ben Affleck	Drama, Kidnapping/Drugs
Gone in 60 Seconds	Nicholas Cage, Angelina Jolie, Robert Duvall		Drama, Car thieves
Gone With The Wind	Cary Grant		Romance, Civil War
Good Doctor: Paul Fleiss Story	George Segal		Heidi Fleiss the Madam
Good German	George Clooney, Tobey McGuire, Kate Blanchett, Beau Bridges	Steven Soderbergh	Drama. post WWII Germany
Good Guys and The Bad Guys	Robert Mitchum, George Kennedy, David Carridine, Martin Balsam, Tina Louise		Western
Good Life	Russell Crowe, Albert Finney	Ridley Scott	Romantic Drama, English Winery
Good Morning, Vietnam	Robin Williams		Drama, Radio Comedian
Good Night and Good Luck	Jeff Daniels, Robert Downey Jr., George Clooney		Drama, Senator McCarthy/Communism
Good Shepherd	Matt Damon, Angolina Joli, Robert De Niro, William Hurt, Alec Baldwin, Joe Pesci, Timothy Hutton	Robert De Niro, Frances Ford Coppola	Drama, CIA
Good Will Hunting	Matt Damon, Ben Affleck, Robin Williams, Minnie Driver		Drama, disturbed math genius
Goodbye Columbus	Richard Benjamin		Romance
Goodbye Girl	Richard Dreyfuss		Comedy, Neil Simon
Goodbye Lover	Don Johnson, Mary Louise Parker, Patricia Arquette, Ellen DeGeneras		Comedy, Drama, Surrealism, Murder
Goodfellas	Ray Liotta, Robert De Niro, Joe Pesci, Paul Scorvino, Vinnie Jones	Martin Scorcese	Drama, Gangsters
Gorillas in the Mist	Sigourney Weaver		Drama, Animal Rights
Gorky Park	William Hurt		Mystery, Russia
Gosford Park	Clive Owen	Robert Altman	Boring
Graduate	Dustin Hoffman, Anita Bryant		Comedy, Mrs. Robinson
Gran Torino	Clint Eastwood, Marty Bufalini, Darlene Bucchare	Clint Eastwood, Kyle Eastwood	Drama, Korean War Vet vs. Inner City Gangs
Grand Canyon	Steve Martin	Lawrence Kasdan	Drama, Friendships
Grand Prix			Drama, Auto Racing
Grand Prix	James Garner, Yves St. Marie	John Frankenheimer	Romantic Drama, Auto Racing
Grand Theft Auto	Emilio Estevez, Demi Moore		Drama, Bank robbers
Gray Lady Down			Drama, Submarine
Grease	John Travolta, Olivia Newton-John		Musical, 50s
Grease II	Michelle Pfeiffer		Musical
Great Escape	Steve McQueen, James Garner, Charles Bronson		Drama, WWII POW's
Great Lover	Bob Hope, Rhonda Fleming, Roland Young, Roland Culver, Jim Backus, Gary Gray		Romantic Drama:  Murder, card sharks on a ship
Great Waldo Pepper	Robert Redford		Old time Aviation
Gremlins		Steven Spielberg	Fantasy
Grey Wolf	Pierce Brosnan, Graham Greene	Richard Attenbourogh	True Story Wilderness Adventure
Grinch	Jim Carrey, Ron Howard	Ron Howard	Christmas Fantasy
Groove Tube			Comedy, TV
Gross Anatomy	Matthew Modine, Daphne Zuniga, Christine Lahti, 	Thom Eberhardt	Drama, medical school
Grosse Pointe Blank	Minnie Driver, John Cusack, Joan Cusack, Dan Aykroyd, Alan Arkin		Comedy, Hit man
Grumpier Old Men	Walter Matthau, Jack Lemmon		Comedy
Grumpy Old Men	Walter Matthau, Jack Lemmon		Comedy
Guard	Don Cheadle		Drama, Irish drug smugglers/police
Guess Who's Coming To Dinner	Sidney Poitier, Katherine Houghton, Katherine Hepburn, Spencer Tracy		Comedy
Gumball Rally			Comedy, Cross Country Racing
Gumshoe			Detective
Gunfighter From Nachez			Western
Hair			Musical
Hang 'Em High	Clint Eastwood, Alan Hale		Western
Hannah and Her Sisters	Woody Allen, Mia Farrow, Michael Caine		Drama, Relationships
Hard Days Night	The Beatles		Musical
Hard to Kill	Steven Seagal		
Hardball	Keanu Reeves, Diane Lane		Drama, Baseball
Hardly Working	Jerry Lewis		Comedy
Hardway	Michael J. Fox, James Woods		Actor living the life of a cop, Drama
Harley Davidson and the Marlboro Man	Don Johnson, MIckey Rourke, Vanessa Williams, Tom Sizemore		Modern cowboys, motorcycles, mobsters
Harry & Walter Go to NY	Elliot Gould, Donald Sutherland		Comedy
Hart's War	Bruce Willis, Colin Farrell, Terrence Howard		Drama, WWII - legal -racism - POWs
Harvey	James Stewart		Comedy
Hatari	John Wayne		African Adventure
Havana	Robert Redford, Lena Olin, Alan Arkin, Raul Julia	Sydney Pollack	Romantic Drama: Gamblers, Cuban Revolution
Hawmps	Benji the dog		Western Comedy, Disney
He Said She Said	Kevin Bacon, Elizabeth Perkins		Romantic Comedy
Heat	Al Pacino, Robert De Niro, Val Kilmer		Bank Robbery
Heaven Can Wait	Warren Beatty, Dyan Cannon, Charles Grodin, Buck Henry, Julie Christie		Comedy, Afterlife
Hebrew Hammer	Adam Goldberg, Andy Dick	Jonathon Kesselman, Comedy Central	Comedy, Jewish Shaft Character
Hello Dolly			Musical
Helmstrom Chronicle			Documentary on Insects
Herbie Rides Again			Disney, Love Bug sequel
High Anxiety	Mel Brooks	Mel Brooks	Satire on Hitchcock Films, Comedy
High Fidelity	John Cusack, Joan Cusack, Joelle Carter, Catherine Zeta Jones, Tim Robbins		Romantic Drama
High Plains Drifter	Clint Eastwood		Western
Hindenberg			Zeppelin Disaster
History of the World, Part I	Mel Brooks		Comedy
History of Violence	Viggo Mortenson, Maria Bello, Ed Harris, William Hurt		Drama, Good Family & Gangsters
Hitler: The last 10 Days	Alec Guiness		Drama
Hoffa	Jack Nicholson, Danny Devito	Danny Devito	Autobiography
HollywoodLand	Ed Asnor, Diane Lane,Ben Affleck		Mystery, Superman:  Murder or Suicide
Holocaust	Meryl Streep, James Woods		Drama
Holy Man	Eddie Murphy, Jeff Goldblum, Kelly Preston, Jon Cryer		Comedy, The Shopping Network
Homework	Joan Collins		Teenage sex and therapy.  Growing up
Homicide	Joseph Montegna		Jewish Cops, Jewish Vigilantes
Hondo	John Wayne, Geraldine Paige		Western
Honor Thy Father			Gangster Drama
Hoodlum	Laurence Fishburne, Andy Garcia, Tim Roth, Vanessa Williams, William Atherton		Mafia
Hook	Robin Williams, Dustin Hoffmann		Peter Pan as an Adult, Adventure
Hooper	Burt Reynolds		Drama
Horse Soldiers	John Wayne, William Holden, Constance Towers	John Ford	Western
Horse Whisperer	Robert Redford, Kristin Scott Thomas, Chris Cooper, Sam Neill, Scarlett Johannsen, Dianne Wiest	Robert Redford	Romantic Drama, horses
Horsefeathers	Marx Brothers	Norman MacLeod	Comedy
Hot Rock	Robert Redford, George Segal, Zero Mostel		Jewel Thieves
Hotel New Hampshire	Jodie Foster, Rob Lowe		Drama, Sex
Houdini			Autobiography
House of Sand and Fog	Jennifer Connelly, Ben Kingsley		Drama, house repossession
How the West Was Won	Robert Mitchum, Richard Widmark, Eli Wallach, Debbie Reynolds, Carolyn Jones, John Wayne, Harry Morgan, James Stewart, Henry Fonda, Spencer Tracy, Karl Malden, George Peppard, Gregory Peck, 	John Ford	Western
How to Stuff a Wild Bikini	Frankie Avalon, Annette Funicello, Buster Keaton, Jody McCrae,  Donna Flora, Harvey Lembeck, Mickey Rooney, Elizabeth Montgomery	William Asher	Musical Comedy
Howard The Duck	Lea Thompson, Ed Gale, Harold Robbins, Holly Robinson	George Lucas	Comedy, alien duck
Hudson Hawk	Bruce Willis, Danny Aiello, Andie McDowell, David Caruso		Comedy, Jewel Thief/Da Vinci
Human Trafficing	Robert Carlyle, Miro Sorvino, Donald Sutherland		Prostitution and Sex Salvery
Hunchback of Notre Dame			Drama
Hunt For Red October	Alex Baldwin		Tom Clancy Novel, Submarines
Hurly Burly	Sean Penn, Kevin Spacey, Chazz Palmarietti, Garry Shandling, Robin Wright Penn, Meg Ryan, Anna Paquin		Drama, Drugs & Depression & Sex
Hustle	Burt Reynolds		Drama, Sex & Drugs & Suicide
Hustle and Flow	Terrance Howard, Isaac Hayes		Drama, drugs and rap and prostitution
I Am Sam	Sean Penn, Michell Pfeiffer, Dakota Fanning, Richard Schiff, Brent Spiner		Drama, Autisim/Child Custody
I Love Trouble	Nick Nolte, Julia Roberts		Romantic Comedy
I Love You to Death	Kevin Kline, Jamie Lee Curtis		Comedy
I Robot	Will Smith		SciFi
Idaho Transfer			Science Fiction
If Looks Could Kill	Richard Greico		Comedy, Spies
I'll Sleep When I'm Dead	Clive Owen, Malcolm McDowell		Drama, Rape and Suicide
Illusionist	Ed Norton		Romantic Drama, Vienna/Murder/Magic
Illustrated Man			Science Fiction, Ray Bradbury
Image of Bruce Lee	Bruce Lee		Karate, Action
Impulse	Theresa Russell, Jeff Fahey		Drama, Police & Sex & Internal Affairs
Impulse	William Shatner		Mad Slasher
In And Out	Kevin Kline, Tom Selleck		Comedy
In Old California	John Wayne, Andrew Dakkar, Binnie Barnes,Ellen Sanford		Western
In The Army Now	Pauly Shore, Andy Dick, Lynn Whitfield, Esai Morales		Comedy
In The Line of Fire	Clint Eastwood, Rene Russo, John Malkovich		Drama, Presidential Assasination
In The Navy	Abbott & Costello, Dick Powell, Claire Dodd, Shemp Howard, Andrew Sisters		Comedy
Inception	Leonardo DiCaprio, Michael Caine, Tom Berenger, Ellen Page	Christopher Nolan	SciFi Action
In-Crowd			Drama, Rich partiers & psycho killer
Indecent Proposal	Demi Moore, Robert Redford, Woody Harrelson		Drama, Sex Scandal
Independence Day	Will Smith, Bill Pullman		Science Fiction, WW III
Indiana Jones & The Last Crusade	Harrison Ford		International Adventure
Informers	Mickey Rourke, Billy Bob Thornton, Kim Basinger, Wynona Ryder, Amber Heard, Brad Renfro, Jon Foster		Drama, Rich unhappy people in Hollywood
Inglorious Basterds	Brad Pitt, Buddy Joe Hooker, Bo Svenson, Mike Myers	Quentin Tarantino	WWII, Jewish soldiers vs. Nazis
In-Laws	Alan Arkin, Peter Falk		Comedy
InnerSpace	Lily Tomlin		Comedy
Innocents Abroad			Drama, Mark Twain
Inside Job			Documentary, Wall Street Crooks
Inside Man	Clive Owen, Jodie Foster, Denzel Washington, Willem Dafoe, Christopher Plummer	Spike Lee	Bank Robbery
Insider	Al Pacino, Russel Crowe, Rip Torn	Michael Mann	Drama, Corporate Tobacco Crooks
Insomnia	Al Pacino, Robin Williams, Hillary Swank		Mystery, Alaska
Internal Affairs	Andy Garcia, Richard Gere		Drama, Police
International	Clive Owen, Naomi Watts		Spy Thriller
Interpreter	Sean Penn, Nicole Kidman	Sydney Pollack	Political Thriller
Into The Night	Jeff Goldblum, Michelle Pfeiffer, John Landis, Dan Aykroyd	John Landis	Action, Jewel Thieves
Into the Wild	William Hurt, Hal Holbrook, Vince Vaughn, Emile Hirsch	Sean Penn	Drama, homeless in Alaska
Intolerable Cruelty	George Clooney, Catherine Zeta Jones, Geoffrey Rush		Romantic Drama
Invasion of the Body Snatchers	Elliot Gould, Jeff Goldblum		Science Fiction
Invention of Lying	Jennifer Garner, Rob Lowe, Christopher Guest		Comedy, Society where nobody lies
IQ	Meg Ryan		Comedy
Island of Dr. Moreau	Marlon Brando, Val Kilmer	John Frankenheimer	Sci Fi: Breeding Man with Animals
Islands in the Stream	George C. Scott		Adventure
Italian Job	Mark Wahlberg, Cherize Theron, Ed Norton, Seth Green, Donald Sutherland		Gold Thieves
Its a mad,mad,mad,mad world			Comedy
It's a Wonderful Life	Jimmy Stewart		Angels, Business
J Edgar	Leonardo DeCaprio, Judi Dench Naomi Watts, Lea Thomson, Kyle Eastwood	Clint Eastwood	Drama, Hoover and the FBI
Jackel	Bruce Willis		Professional Killer
Jackie Brown	Samuel Jackson, Robert De Niro, Bridget Fonda, Pamela Grier	Quentin Tarantino	Gangsters, Pulp Fiction Style
Jamaica Inn		Alfred Hitchcock	Mystery
Jaws	Roy Schneider, Robert Shaw, Richard Dreyfuss	Steven Spielberg	Drama, Sharks
Jaws II	Roy Schneider		Drama, Sharks
Jay and Silent Bob Strike Back	Keith Smith, Shannon Elizabeth, Judd Nelson, Chris Rock	Keith Smith	Comedy
Jeremiah Johnson	Robert Redford		Western
Jerk	Steve Martin, Bernadette Peters		Comedy
Jerry McGuire	Tom Cruise; Cuba Gooding, Jr., Jay Mohr, Renee Zellweger		Romance, Sports Agent
Jetsons			Cartoon
Jewel of the Nile			South American Adventure
JFK	Kevin Costner, Jack Lemmon	Oliver Stone	Drama, Assasination
Joe Kidd	Clint Eastwood		Western
Johnny Dangerously	Michael Keaton		Comedy, Mafia
Johnny English	Rowan Atkinson		Secret Agent Comedy
Johnny Mnemonic	Keeanu Reeves		Comic Book Science Fiction
Johnson County War	Luke Perry, Tom Berenger, Burt Reynolds, Michelle Forbes, Rachel Ward		Western
Journey to the Far Side of the Sun			Science Fiction
Judgment Night	Emilio Estevez		Drama, Gangsters
Jumanji	Robin Williams		Adventure
Jungle Book			Adventure, 1942
Jungle Book			Disney Cartoon
Jungle Book 2	John Goodman, Haley Joel Osmant, Phil Collins		Disney Cartoon
Jurassic Park	Jeff Goldblum	Steven Spielberg	Science Fiction, Dinosaurs
Juror	Demi Moore, Alec Baldwin		Mafia
Just Cause	Blair Underwood, Sean Connery		Mystery
Just the Way You Are	Kristie McNicholls, Michael Ontkean		Romance, skiing
JW Coop			Drama, Rodeos
JW Coop	Cliff Robertson		Drama, Rodeos
Kettle of Fish	Matthew Modine, Gina Gershon, Michael Mailer		Romantic Comedy
Kicking and Screaming	Eric Stoltz, John Lehr, Elliot Gould, Chris Eigeman, Josh Hamilton, Olivia D'abo, Parker Posey, Cara Bueno		Romantic Drama, College Grads
Kill Bill 1	Uma Thurman, Lucy Liu, Darryl Hannah, David Carradine	Quentin Tarantino	Action, Death Squad
Kill Bill Volume Two	Uma Thurman, Michael Madsen, Darryl Hannah	Quentin Tarantino	Drama, killers
Killer Elite	Jason Statham, Robert De Niro, Clive Owen		Drama, International spies/assasins
Killing Fields	Sam Watterston, Craig T. Nelson, John Malkovich		Drama, Vietnam War
Killing of a Chinese Bookie			Gangsters
King Kong			Monster
King of New York	Christopher Walkin, Lawrence Fishburne, David Caruso, Wesley Snipes		Drama, drug dealers and gangs
Kingdom of Heaven	Orlando Bloom, Liam Nielson	Ridley Scott	Middle Ages War
Kiss Kiss Bang Bang	Robert Downey, Jr.; Val Kilmer, Michelle Moghnahan, Corbin Bernson, Laurence Fishburn	Shane Black	Mystery Comedy -- Show Biz
Kissing a Dream			Soft Porn Drama
Klute	Jane Fonda, Donald Sutherland, Roy Scheider, Jane Stapleton		Drama, Runaway & Call Girls & Murder
Knight and Day	Tom Cruise, Cameron Diaz		Expionage Action, comedy
KPax	Kevin Spacey, Jeff Bridges		Sci Fi
Kramer Vs. Kramer	Dustin Hoffman, Meryl Streep, Jo Beth Williams		Drama, Divorce & Court Room
LA Confidential	Kim Basinger, Kevin Spacey, Russell Crowe, Danny Devito		Mystery
LA story	Steve Martin	Lawrence Kasdan	Drama, Friendships
Lansky	Richard Dreyfuss, Beverly D'Angelo		Drama, Meyer Lansky
Last American Hero	Jeff Bridges		Auto Racing
Last Detail	Jack Nicholson, Randy Quaid		Escorting/Entertaining a prisoner
Last Don	Penelope Ann Miller, Daryl Hannah, Kirstie Alley, Danny Aiello, Jason Gedrick, Joe Montegna	Graeme Clifford, Mario Puzo	Mafia Drama
Last Goodbye	Robert Mitchum		Mystery, Raymond Chandler's Sam Spade
Last Man Standing	Bruce Willis, Christopher Walken, Bruce Dern		Gangster Botlegging Drama
Last of Sheila	Richard Benjamin		Mystery, Rich people
Last of the Mohicans			Western
Last Samurai	Tom Cruise, William Atherton		Japanese War Movie
Last Tycoon	Robert De Niro, Robert Mitchum, Jack Nicholson, Theresa Russell		Romantic Drama, Holleywood Producer
Last Unicorn	Mia Farrow, Alan Arkin		Cartoon
Last Waltz			
Lawless Breed			
Lawnmower Man			Science Fiction, Steven King
Laws of Attraction	Pierce Brosnan, Julianne Moore, Michael Sheen		Romantic Comedy
Lazerblast			Science Fiction
League of Their Own	Madonna, Rosie O'Donnell, John Lovutz, Geena Davis		Woman's Baseball
Legally Blonde	Reese Witherspoon		Comedy, Harvard Law School
Legend of Boggy Creek			Horror
Lethal Weapon 2	Mel Gibson, Danny Glover		Cops, Action
Lethal Weapon 3	Mel Gibson, Danny Glover		Cops, Action
Let's Do it Again			Comedy
Liar Liar	Jim Carey		Comedy, Crooked Lawyer
Liberty Heights	Joe Montegna	Barry Levinson	Drama, Jewish life in the 50s
Licsence to Kill	Timothy Dalton, Bernicio Del Toro, Wayne Newton	Brocolli & Saltzman	James Bond
Life and Times of Judge Roy Bean			Western
Life Force		British	Science Fiction
Life Goes On	Vince Orlando, Jeanette Quesida, Stacey Szymanski, Cordell Gibbs, Allen Smith III, Alicia Hosey, Rebecca Shelby, Matt Smith, Obie Trice and ME	Brian Lawrence	Romantic Drama, Drugs
Limey	Terence Stamp, Lesley Ann Warren, Peter Fonda	Steven Soderbergh	Mystery
Lion King			Disney, Cartoon
Lisa Bright and Dark			Schizophrenia
Little Big Man	Dustin Hoffman, Faye Dunaway, Martin Balsam		Western
Little Fockers	Ben Stiller, Robert De Niro, Owen Wilson, Dustin Hoffman, Teri Polo, Jessica Alba, Blythe Danner, Barbara Streisand		Romantic Comedy
Little Mermaid			Disney, Cartoon
Little Shop of Horrors	Steve Martin, Rick Moranis		Comedy, Man Eating Plant
Live and Die in LA	Will Peterson, William DaFoe		 Counterfeiting
Live and Let Die	Roger Moore, Jane Seymour, Clifton James	Brocolli & Saltzman	James Bond
Live Free or Die Hard	Bruce Willis, Kevin Smith		Action, Computer Hackers
Living Daylights	Timothy Dalton	Brocolli & Saltzman	James Bond
Loaded Weapon I	Kathy Ireland, Emilio Estevez		Satire---Police movies
Logan's Run	Edward G. Robinson		Science Fiction
Lonesome Dove	Robert Duvall, Tommy Lee Jones, Robert Urich, Frederick Forrest, Ricky Schroeder, Danny Glover, Angelica Huston, Diane Lane		Western
Longest Night			True Story, Kidnapping
Looking for Mr. Goodbar	Diane Keaton, Richard Gere		One NIght Stands
Looney Tunes	Brendan Fraser, Jenna Elfman, Steve Martin, Heather Locklear, Bugs Bunny, Daffy Duck, Timothy Dalton	Joe Dante	Cartoon and Live Action
Looney Tunes Golden Collection	Vol 1., Disk 1		Animation
Lord of the Rings	Christopher Lee, Liv Tyler		Fantasy Action
Lost in Space	William Hurt, Matt LeBlanc, June Lockhart		Sci Fi
Love and Death	Woody Allen, Diane Keaton		Comedy, Russia
Love At Large			
Love Boat	Season 1, Disk 1		Romantic Comedy, Cruise
Love Boat	Season 1, Vol 2, Disk 1, Gavin MacLeod	Aaron Spelling	
Love Boat	Season 1, Vol. 2, Disk 2		
Love Boat	Season 1, Volume 1, Disk 3		Romantic Comedy
Love Boat	Season 1, Vol. 2, Disk 3		
Love Boat	Season 1, Vol. 2, Disk 4		
Love Bug			Disney
Love Happy	Marx Brothers, Marilyn Monroe, Raymond Burr		Comedy
Loverboy			
Luck of The Draw	Frank Gorshin, Eric Roberts, Dennis Hopper		Drama, Counterfeiting
MacGyver Season 1 Disc 1	Richard Dean Anderson, Dana Elkar	Henry Winkler, John Rich	American Spy Action
MacGyver Season 1, Disc 3	Richard Dean Anderson, Dana Elkar, Roberto Ramones	Henry Winkler, John Rich	Spy Thriller
MacGyver, "Season 1, Disc 2	Richard Dean Anderson, Dana Elkar	Henry Winkler, John Rich	American Spy Action
Mad Adventures of Rabbi Jacob	Louis De Funes	Gerald Oury	French Comedy
Mad Love	Chris O'Donnell, Drew BarryMore		Drama, Schizophrenic
Made in Heaven	Timothy Hutton		Drama, Romance, Reincarnation
Magnificent Seven	Yul Brynner, Steve McQueen, Gene Barry, Charles Bronson, James Coburn		Western
Magnum Force	Clint Eastwood		Dirty Harry
Majestic	Jim Carrey		Drama, Another Life
Making The Grade	Judd Nelson		Comedy, College
Making Trouble	Gilda Radner, Madeline Kahn, Joan Rivers, Fanny Brice, Bill Murray, Martin Short		Documentary, Jewish Female Comedians
Malone	Burt Reynolds		Super Cop
Maltese Falcon	Humphrey Bogart		Detective Mystery
Man on a Swing	Cliff Robertson, Joel Grey		Detective Mystery
Man on the Moon	Jim Carey, Danny Devito	Danny Devito	Drama, Comedian Andy Kauffmann
Man Who Fell to Earth	David Bowie		Science Fiction
Man Who Knew Too Much	James Stewart, Doris Day	Alfred Hitchcock	Adventure -- London, Morocco, kidnapping
Man Who Loved Cat Dancing	Burt Reynolds		Western
Man Who Shot Liberty Valance	James Stewart, John Wayne, Lee Marvin, Vera Miles, Denver Pyle, John Carradine	John Ford	Western
Man Who Would Be King	Sean Connery		Adventure, Medieval times
Man With One Red Shoe	Tom Hanks, Lori Singer		Comedy, Spies
Man With the Golden Gun	Roger Moore	Broccoli and Saltzman	James Bond
Man With Two Brains	Steve Martin		Comedy
Manchurian Candidate	Denzel Washington, Meryl Streep, Jon Voight		Drama, Mind Control
Manhunter	Will Peterson	Michael Mann	Detective
Mannequin	Andrew McCarthy, Kim Cattrall, James Spader		Romantic Comedy
Marathon Man	Dustin Hoffmann, Laurence Olivier		Adventure
Married to the Mob	Alec Baldwin, Michelle Pfeiffer, Dean Stockwell, Matthew Modine		Comedy, Mafia
Marrying Man	Alec Baldwin, Kim Basinger		Comedy, Gangsters, Romance
Mars Attacks	Michael J. Fox, Martin Short	Tim Curry	Comedy, Sci Fi
Mary Poppins	Julie Andrews, Dick Van Dyke		Disney Musical
Mask	Jim Carey, Cameron Diaz		Comedy
Masquerade	Rob Lowe		Mystery
Master	Phillip Seymour Hoffmann, Joaquin Phoenix, Laura Dern, Amy Adams		Drama, religious cult
Matador	Pierce Brosnan		Dark Comedy, Hit Man
Matrix	Keanu Reeves		Sci Fi
Maverick	James Garner, Jodie Foster, Mel Gibson		Western, based in TV series
Max Dugan Returns			Comedy, Neil Simon
McClintock	John Wayne, Maureen O'Hara, Jerry Lee Lewis		Western Comedy
McHale's Navy	Tom Arnold, Ernest Borgnine		Comedy
Me, Myself, and Irene	Jim Carey, Renee Zellweger		Comedy, Split Personality
Mean Season			Professional Thieves
Mean Streets	Robert De Niro		Drama, Gangsters
Meatballs	Bill Murray		Comedy, Summer camp
Mechanic	Charles Bronson, Jan Michael Vincent, Jill Ireland		Professional Assasins
Medicine Man	Sean Connery		Drama, Scientists in the Jungle
Meet Dave	Eddie Murphy, Elizabeth Banks		Comedy, Sci Fi/1 inch tall people
Meet Joe Black	Brad Pitt, Anthony Hopkins		Drama, death rep. from heaven
Meet the Parents	Robert De Niro, Ben Stiller, Blythe Danner		Romantic Comedy
MeetThe Fockers	Robert De Niro, Ben Stiller, Blythe Danner		Romantic Comedy
Memoirs of a Geisha		Steven Spielberg (Producer)	Drama, Life as a Geisha
Men at Work	Charlie Sheen, Emilio Estevez		Comedy, Garbage Men
Men in Black	Will Smith, Tommy Lee Jones		Comedy, Sci Fi
Men in Black II	Tommy Lee Jones, Will Smith, Rip Torn		Sci Fi Comedy
Men in Black, III	Tommy Lee Jones, Will Smith		Sci Fi Comedy
Men of Honor	Robert De Niro, Cuba Gooding Jr., Hal Holbrook, Cherlize Theron		Navy Drama, racsism
Mercury Rising	Alec Baldwin, Bruce Willis		Drama, Govt Coverup
Message in a Bottle	Robin Wright Penn, Kevin Costner, Paul Newman		Romantic Drama
Messenger of Death			
Metro	Eddie Murphy		Police drama
Metropolitan			Drama, rich & intelligent & isolated young adults
Mexican	Brad Pitt, Julia Roberts, James Gandolfini		Drama, Mafia and Mexico
Miami Vice	Jamie Foxx, Colin Farrell	Michael Mann	Crime Drama
Mid Summer Night's Sex Comedy	Woody Allen, Mia Farrow	Woody Allen	Comedy
Midnight in the Garden of Good and Evil	John Cusack, Kevin Spacey, Alison Eastwood	Clint Eastwood	Mystery, trial, voodoo
Millers Crossing	John Turturro, Albert Finney	Joel and Ethan Coen	30s Gangster Drama
Million Dollar Baby	Clint Eastwood, Morgan Freeman, Hilary Swank	Clint Eastwood	Drama, Boxing
Minority Report	Tom Cruise, Colin Farrell, Max Von Sydow	Steven Spielberg	Sci Fi
Miracle on 34th Street			
Mirror Cracked			Detective Mystery, Agatha Christie's Miss Marple
Mirror Images			Drama
Misery	James Caan		Drama, Fatal Attraction, Stephen King
Miss Congeniality	Sandra Bullock, Candice Bergen, William Shatner, MIchael Caine		Comedy, Beauty Pageant, FBI
Miss Pettigrew Lives For a Day	Frances MacDormand, Amy Adams		Romantic Drama
Missing	Sissy Spacek, Jack Lemmon		Drama, Central America
Mission Impossible	Tom Cruise, Jon Voight	Tom Cruise	Drama, Spies
Mission Impossible II	Tom Cruise, Anthony Hopkins	John Woo	Drama, Spies
Mission to Mars	Tim Robbins, Kim Delaney, Gary Sinise		Sci Fi
Missouri Breaks			Western
Mixed Nuts		Nora Ephron	Romantic Comedy
Mobsters	Christian Slater, Richard Greko		Mafia
Momma Mia	Amanda Zeyfried, Meryl Streep, Pierce Brosnon, Colin Firth		Musical Romantic Comedy, ABBA
Moneyball	Brad Pitt, Philip Seymour Hoffman		Baseball, true story of 2001 Oakland A's
Monkey Business	Marx Brothers	Norman MacLeod	Comedy
Monsters, Inc.	John Goodman, Billy Crystal, Jennifer Tilly, James Coburn		Disney Animation
Moonlight Kingdom	Bruce Willis, Ed Norton, Bill Murray, Frances MacDormand		Romantic Comedy, 12 yr old elopers
Moonlighting	Season 1 & 2:  Disc 1.  Bruce Willis, Cybil Shepherd; Alyce Beasley		Romantic Comedy, Detective Agency
Moonlighting	Season 1& 2, disk 2.  Bruce Willis, Cybil Sheppard		
Moonraker	Roger Moore, Richard Kiel	Broccoli & Saltzman	James Bond
Moonstruck			Drama, Italy
More American Graffiti	Charles Nelson Reilly	Ron Howard	
Mortal Thoughts	Demi Moore, Bruce Willis, Harvey Keitel		Detective
Moscow on the Hudson	Robin Williams		Romantic Comedy
Mother, Jugs, and Speed	Bill Cosby, Raquel Welch		Comedy, Ambulances
Mr. and Mrs. Smith	Brad Pitt, Angelina Jolie, Vince Vaughn		Comedy, hit men
Mr. Baseball	Tom Sellick		Baseball
Mr. Brooks	Kevin Costner, William Hurt, Demi Moore, Dane Cook		PsychoDrama, serial Killer
Mr. Saturday Night	Billy Crystal		Comedy, StandUp Comedians
Much Ado About Nothing	Keanu Reeves, Kate Beckansale, Denzel Washington, Emma Thompson, Michael Keaton	William Shakespeare	Shakespeare Romantic Comedy
Muholland Falls	Christopher Penn		Drama, cops
Multiplicity	Michael Keaton		Comedy, cloning
Munich		Steven Spielberg	Drama, 1972 Olympic kidnappings
Munster Go Home	Fred Gwynn		Comedy
Murder By Death	Peter Falk		Detective Comedy
Murder by Numbers	Sandra Bullock, Chris Penn		Mystery
Murder on the Orient Express	Peter Ustinov		Detective Mystery, Agatha Christie's Hercule Poirot
Murphy's Law	Charles Bronson		Drama, Cops/Murder Frame/Gangsters
My Best Friend's Wedding	Julia Roberts, Cameron Diaz		Romantic Comedy
My Big Fat Greek Wedding			Romantic comedy
My Cousin Vinny	Fred Gwynn, Joe Pesci		Comedy, Law
My Favorite Year			Drama-Friends-1954
My Name is Nobody			Western
My Stepmother is an Alien	Dan Aykroyd, Kim Basinger		Comedy
My Two Jakes	Jack Nicholson, Meg Tilly, Harvey Keitel, Madeleine Stowe	Jack Nicholson	Mystery
Mystic River	Sean Penn, Tim Robbins, Kevin Bacon, Lawrence Fishburne	Clint Eastwood	Drama, Murder Investigation
Naked Face	Roger Moore		Psychologist, Gangsters
Naked Gun	Leslie Nielson, OJ Simpson, Reggie Jackson, Ricardo Montalban, Priscilla Presley		Comedy, Cops
Naked Gun 2.5	Leslie Nielson, OJ Simpson, Priscilla Presley		Comedy, Cops
Naked Gun 3.33 - The Final Insult	Leslie Neison, OJ Simpson, Priscilla Presley		Comedy, Cops
Nashville	Henri Gibson	Robert Altman	Drama, Musical
National Parks:  America's Best Idea	Disk 1	Ken Burns	Documentary
Natural	Robert Redford, Kim Basinger, Glenn Close		Baseball
Natural Born Killers	Woody Harrelson, Tommy Lee Jones, Robert Downey Jr., Rodney Dangerfield	Oliver Stone, Quentin Tarantino	Drama, killers
Neighbors	John Belushi, Dan Aykroyd		Comedy
Net	Sandra Bullock		Computer Terrorists
NetForce	Kris Kristofferson, Judge Reinhold, Brian Dennehy	Tom Clancey (Writer)	Drama, Sci Fi Internet Crime
Network	Peter Finch, Faye Dunaway		Drama, TV
Nevada Smith	Steve McQueen		Western
Never Back Down			Drama, Street fighting
Never Let Me Go	Andrew Garfield, Carey Mulligan, Keira Knightly		SciFi, Cloning for body parts
Never Say Never Again	Sean Connery	Broccoli and Saltzman	James Bond
New Jack City	Wesley Snipes, IceT, Judd Nelson, Vanessa Williams		Black Mafia
New York Stories	Roseanna Arquette, Woody Allen	Woody Allen, Francis Ford Coppola, Martin Scorcese	Comedy--3 Skits
Newton Boys	Matthew McConaughey, Ethan Hawke		Drama, Bank Robbers
Next Man			
Night at The Opera	Marx Brothers		Comedy
Night at the Roxbury	Richard Grieco, Will Farrell, Chris Katton, Loni Anderson, Dan Nahaya, Molly Shannon		Comedy, night clubs
Night of the Grizzly	Clint Walker, Keenan Wynn, Ron Ely		Western
Night Shift	Henry Winkler, Michael Keaton	Ron Howard	Comedy
Nightfall			Science Fiction, Isaac Asimov
Nightmare Before Christmas		Tim Curry	Animation
Nine and a half weeks	Mickey Rourke, Kim Basinger		Drama, Relationship
Nine to Five	Dolly Parton, Lily Tomlin		Comedy, Workplace
Nixon	Anthony Hopkins, Ed Harris	Oliver Stone	Drama
No Time For Sergeants	Andy Griffith, Don Knotts, Myrom McCormick		Comedy, Air Force
Normal Life			
North by Northwest	Carey Grant, Eva Marie Saint, James Mason	Alfred Hitchcock	Adventure
North to Alaska	John Wayne		Romantic Gold Rush Adventure
Not Another Teen Movie			Comedy, teen comedy satire
Notorious		Alfred Hitchcock	
Nutty Professor	Jerry Lewis		Comedy
Oceans 11	Brad Pitt, Matt Damon, George Clooney, Casey Affleck, Don Cheadle, Elliot Gould, Andy Garcia, Julia Roberts		Professional Theives
Oceans 12	Brad Pitt, Matt Damon, George Clooney, Casey Affleck, Don Cheadle, Elliot Gould, Andy Garcia, Julia Roberts, Catherine Zeta Jones		Professional Theives
Ocean's Eleven	Cesar Romero, Angie Dickenson, Sammy Davis Jr., Dean Martin, Frank Sinatra, Peter Lawford, Joey Bishop		Las Vegas Heist Comedy
Octopussy	Roger Moore, Desmond Llewelan, Maud Adams	Albert Broccoli	James Bond
Odd Couple	Jack Lemmon, Walter Matthau	Neil Simon	Comedy
Oddessa File	Jon Voight		Mystery, Nazis
Ode to Billy Joe			Romantic drama
Office Space	Jennifer Aniston	MIke Judge	Comedy, computer company
Oh God!	George Burns, Teri Garr, John Denver		Comedy
Oklahoma			Musical
Oklahoma Crude			Drama, Oil
OldBoy			Korean Prison Movie
Oliver			Musical, Pickpockets & Orphanage
Omega Man	Charleton Heston		SciFi
Omen			Child Murderers, Kinetics
On Any Sunday			Documentary, Motorcycle racing
On Any Sunday II			Motorcycle Racing Documentary
On Her Majesty's Secret Service	George Lazenby, Diana Rigg, Telly Savales	Peter Hunt, Brocolli and Saltzman	James Bond
On the Beach			Drama, Nuclear holocaust
On the Town	Frank Sinatra, Ann Miller		Musical, NY City
On The Waterfront	Marlon Brando, Eva Marie Saint, Karl Malden, Lee J. Cobb, Rod Steiger	Elia Kazan, Sam Spiegel	Romantic Drama, Gangsters
Once Upon a Time in America	Robert De Niro, James Woods, William Forsythe, Elizabeth McGovern, Jennifer Connelly 	Sergio Leone	Gangsters:  Prohibition
Once Upon a Time in China	Jet Li		Drama, Kung Fu
Once upon a Time in Mexico	Johnny Depp, Antonio Banderas, Selma Hayek, Mickey Rourke, Cheech Marin, William Dafoe	Robert Rodriquez	Mexican Drug Cartel
Once Upon a Time in The West		Sergio Leone	Western
One & Only	Henry Winkler, Kim Darby, Harold Gould, Harre Villechaise		Comedy, Big time Wrestling
One Hour Photo	Robin Williams, Connie Nielson		Psychopathic thriller
One Night at McCools	Liv Tyler, Michael Douglas, Matt Dillon, John Goodman, Reba McIntyre, Paul Reisner	Michael Douglas	Romantic Comedy, Psychology
Open Range	Kevin Costner, Robert Duvall, Annette Bening, Diego Luna		Western
Opportunity Knocks	Dana Carvey		Comedy, Con Artists
Ordinary People	Timothy Hutton, Mary Tyler Moore, Donald Sutherland	Robert Redford	Family Problems
Other Guys	Mark Wahlburg, Will Farrell, Michael Keaton, Samuel L. Jackson		Comedy, NYPD and Ponze schemes
Out of Sight	George Clooney, Jennifer Lopez, Dennis Farina, Michael Keaton		Bank Robber, FBI, Jewel Heist
Out of Time	Denzel Washington		Mystery
Out to Sea	Walter Matthau, Jack Lemmon, Dyan Cannon, Brent Spiner		Comedy, Ship Cruise
Outbreak	Dustin Hoffman, Kevin Spacey		Virus Outbreak
Outland	Sean Connery, Peter Boyle		SciFi
Outlaws is Coming	Three Stoodges, Adam West, Nancy Kovack, Emil Sitka	Norman Maurer	Comedy
Outsiders	Tom Cruise, Patrick Swayze		Hi School gangs
Pacific Heights	Matthew Modine, Melanie Griffith, Michael Keaton, Carl Lumley		Drama, Landlords & Crooks
Pale Rider	Clint Eastwood, Christoper Penn, Carrie Snodgrass, Richard Dysart		Western
Papillon	Dustin Hoffman, Steve McQueen		Drama, Prison
Paradise	Melanie Griffith		Family Problems
Pardners	Jerry Lewis, Dean Martin		Comedy, Western
Pardon My Sarong	Dean Martin		Western
Party	Peter Sellers		Comedy
Patch Adams	Robin Williams		Drama, Medical School
Payback	Mel Gibson		Action, Mafia
Paycheck	Ben Affleck, Uma Thurman		Sci Fi
Pearl Harbor	Ben Affleck, Kate Beckinsale, John Voight, Cuba Gooding Jr., Alec Baldwin	Jerry Bruckenheimer	WWII drama
Pelican Brief	Julia Roberts, Denzel Washington	John Grisham novel	Drama, Political Crimes
Pennies From Heavan	Steve Martin		Musical
Perfect World	Clint Eastwood, Kevin Costner		Drama,  Cops & Robbers
Perks of Being a Wallflower	Dylan MacDermott, Joan Cusack, Brian Balzerini	John Malkovich	High School Drama
Peter Pan			Cartoon
Picture Perfect	Jennifer Aniston		Comedy, Romance
Pink Panther	Peter Sellers		Comedy
Pink Panther Strikes Again	Peter Sellers		Comedy
Pinnochio			
Pirate Radio	Phillip Seymour Hoffmann		Comedy, British Rock radio station
Pirates of The Carribean	Johnny Depp	Jerry Bruckheimer	Disney
Pitch Black	Radha Mitchell, Vin Diesel, Cole Hauser		Sci Fi
Planet of The Apes	Charleton Heston		SciFi
Planet of the Apes-2001	Mark Wahlburg, Tim Roth, Kris Kristofferson	Tim Burton	Sci Fi
Platoon	Tom Berenger, Charlie Sheen, Wiliam DaFoe	Oliver Stone	Vietnam War
Play Misty For Me	Clint Eastwood		Drama, Radio DJ & Fatal Attraction
Players	Pancho Gonzales		Drama, Romance, Tennis
Pleasantville	William H. Macy, Joan Allen, Reese Witherspoon, Don Knotts		Comedy, 50's TV show.  Twilight Zone
Pledge	Jack Nicholson, Robin Wright Penn, Harry Dean Stanton, Mickey Rourke	Sean Penn	Drama, Serial Killer
Pocohontos		Walt Disney	Cartoon
Point Blank	Lee Marvin, Angie Dickinson, Carrol O Conner, James Sikking		Crime Drama
Point Break	Patrick Swayze, Keeanu Reeves		FBI, Bank Robbers
Point of No Return	Bridget Fonda, Harvey Keitel		Govt. Assasins
Police Academy	Steve Gettenberg, Kim Catrall, Donovan Scott, Bubba Smith	Jerry Paris	Comedy
Police Academy 2	Steve Guttenberg, Tim Kazurinsky, Bubba Smith	Jerry Paris	Comedy
Police Academy 3	Steve Gettenberg, Donovan Scott, Bubba Smith, Tim Kazurinsky, Michael Winslow, Bobcat Goldwaith	Jerry Paris	Comedy
Pope of Greenwich Village	Mickey Rourke, Darryl Hannah		Gangsters, brothers having fun
Poseidon Adventure	Ernest Borgnine, Shelly Winters		Drama, Shipwreck
Postcards From The Edge			Drama, Female friendships
Postman Always Rings Twice	Lana Turner		Mystery
Pray For The Angels			
Prelude to a Kiss	Alec Baldwin, Meg Ryan		Romantic Drama and Fantasy
Premonition	Sandra Bullock		Death and Clairavoyance
Presidio	Mark Hamill, Sean Connery, Meg Ryan		Murder mystery
Presumed Innocence	Harrison Ford		Murder trial
Pretty in Pink	Andrew McCarthy, Molly Ringwald, Jon Cryer		High School Love
Pretty Poison	Anthony Perkins, Tuesday Weld		Mystery, Romantic Drama
Pretty Woman	Richard Gere, Julia Roberts		Love Story, Hookers
Pride and Glory	Ed Norton, Colin Farrell, Jon Voight		Drama, Crooked Cops
Pride of the Yankees	Gary Cooper, Babe Ruth, Bill Dickey		Drama, Lou Gehrig story
Prisoner of 2nd Ave.	Jack Lemmon		Unemployment in NYC
Prizzi's Honor	Jack Nicholson, Kathleen Turner		Drama, Mafia
Producers		Mel Brooks	Comedy, Theatre
Profane Comedy			
Professional	Sylvester Stallone		Mafia
Proof of Life	Meg Ryan, Russell Crowe, David Caruso		Drama, kidnapping in S. America
PS I Love You	Hilary Swank, Lisa Kudrow, Kathy Bates		Irish Romantic Drama/Comedy
Psycho		Alfred Hitchcock	Horror
Public Enemies	Johnny Depp, Christian Bale	Michael Mann	Drama, John Dillinger
Pulp Fiction	John Travolta, Samuel Jackson, Uma Thurman, Harvey Keitel	Quentin Tarantino	Gangsters
Purple Rose of Cairo	Jeff Daniels	Woody Allen	Drama, Movie Character comes to life
Quick Change	Bill Murray		Comedy, Cops & Robbers
QuickSilver	Kevin Bacon		Bicycle Messengers
Quiet Earth			Sci Fi, Australian Picture
Quiz Show		Robert Redford	Game Show Scandal
Race With The Devil	Peter Fonda		Twilight Zone, Car chases
Radio Days	Michael Tucker	Woody Allen	Comedy, Radio and before TV
Rage	George C. Scott		Revenge for Death
Raid on Entebbe	Charles Bronson, Sylvia Sidney, Peter Finch, Ed Constantine, Yaphet Lotto, Martin Balsam		Drama, Palestinian terrorists
Raiders of the Lost Ark	Harrison Ford, Karen Allen		Asian Adventure
Rain Man	Tom Cruise, Dustin Hoffman		Handicapped Person
RainMaker	Matt Damon, Mickey Rourke, Danny Devito	John Grisham novel	Courtroom drama
Rancho Deluxe	Jeff Bridges		Western, Comedy, Sex
Ransom	Rene Russo, Mel Gibson	Ron Howard	Kidnapping
Rat Race	Cuba Gooding, Jr.; Jon Lovitz, Whoopi Goldberg, Seth Green		Comedy
Reader	Ralph Fiennes, Kate Winslet		Romantic Drama, Nazi War criminals
Real Steel	Hugh Jackman, Olga Fonda		SciFi, Rockem Sockem Robots
Rear Window	James Stewart, Raymond Burr	Alfred Hitchcock	Murder Mystery
Recruit	Al Pacino, Colin Farrell		Drama, CIA Training
Red Corner	Richard Gere, Bai Ling, Bradley Whitford		Mystery, Chinese Conspiracy
Red Dawn			War
Red Heat	Jim Belushi, Arnold Shwarzenegger		Cops
Red Planet Mars			Sci Fi
Red River	John Wayne, Richard Brennan,Montgomery Clift, Harry Carey Sr., Harry Carey Jr.	Howard Hawk	Western
Reds	Warren Beatty, Jack Nicholson, Diane Keaton		Drama
Ref	Denis Leary, Kevin Spacey		Comedy, Kidnapping
Reindeer Games	Ben Affleck, Charlize Theron, Dennis Farina, Gary Sinese, Isaac Hayes	John Frankenheimer	Drama, Casino robbers
Religulous	Bill Maher	Bill Maher	Documentary, Agnosticism
Reluctant Astronaut	Don Knotts, Leslie Nielson		Comedy, NASA
Report to the Commissioner	Michael Moriarty		Murder Mystery
Return of a Man Called Horse			Western
Return of the Pink Panther	Peter Sellers		Comedy
Revenge	Kevin Costner, Madeleine Stowe, Anthony Quinn, John Leguizamo	Tony Scott	Drama, Romance/Mexican Mafia/Murder
Revenge of the Nerds	Ted McGinley		Comedy, College
Revenge of the Nerds II: Nerds in Paradise			Comedy, College
Revenge of the Nerds IiI: Next Generation			Comedy, College
Ride 'Em Cowboy	Abbott & Costello		Comedy
Right Stuff	Ed Harris, Sam Shepard		US Space program
Rio Bravo	John Wayne		Western
Rio Grande	John Wayne, Maureen O'Hara, Harry Carey Jr., Ben Johnson	John Ford	Western
Rio Lobo	John Wayne		Western
Ripley's Game	John Malkovich		Drama, Professional Killers
Rising Sun	Sean Connery, Wesley Snipes, Harvey Keitel	Michael Crichton	Mystery, Japanese
Risky Business	Tom Cruise, Rosanna Arquette		Pimps & Hookers
River Wild	Kevin Bacon, Merryl Streep		Drama, Murder/kidnapping
Road to Morocco	Bing Crosby, Bob Hope		Musical
Road to Perdition	Tom Hanks, Jude Law, Paul Newman, Jennifer Jason Leigh		Mafia Drama
RoadHouse	Patrick Swayze, Ben Gazarra, Red West		Drama, Bar Bouncers
Robbery			
Robin Hood: Men in Tights	Dom Deluise, Mel Brooks	Mel Brooks	Comedy/Musical
Robocop			Sci Fi
Rock 'n Roll High School			Comedy
RockNRolla			British/Russian Gangsters
Rocky	Sylvester Stallone, Talia Shire		Boxing
Rocky Horror Picture Show			Musical
Rodan			Godzilla's rival
Rollerball	James Caan		Sci Fi, sports
Rollover	Kris Kristofferson, Jane Fonda		Economic disaster
Romancing the Stone	Michael Douglas, Kathleen Turner, Danny Devito		South American Adventure
Romeo & Juliet (1996)	Brian Dennehy, Leonardo Decaprio, Claire Danes		Musical, Shakesphere
Ronin	Robert De Niro	John Frankenheimer	Crime Drama
Rookie	Clint Eastwood, Charlie Sheen		Cops
Room Service	Marx Brothers		Comedy
Rooster Cogburn	John Wayne		Western, True Grit Sequel
Rosebud			Mad Slasher
Rounders	Matt Damon, Ed Norton, John Malkovich, Martin Landau, John Turturro		Drama, Gambling pros
Roxanne	Steve Martin, Darryl Hannah		Firemen, romance, comedy
Rumblefish	Mickey Rourke		InnerCity gang fights
Runaway Jury	John Cusack, Dustin Hoffmann, Gene Hackman, Rachel Weicz, Jennifer Beals, Nora Dunn	John Grisham	Legal Drama, Jury Tampering
Runnin' Down a Dream	Tom Petty and The Heartbreakers		Documentary
Rush Hour	Jackie Chan, Chris Tucker		Comedy, Karate
Russians are Coming, Russians are Coming	Alan Arkin		Comedy
Sacco & Venzetti			True Story-Bank robbers
Salzburg Connection			
Samsara			Art & Photography of the World
Santa Clause II	Tim Allen, Elizabeth Mitchell		Comedy
Saturday Night Fever	John Travolta		Drama, dancing
Save the Tiger	Jack Lemmon		Arson
Saving Private Ryan	Tom Hanks, Dennis Farina, Matt Damon	Steven Speilberg	Drama, World War II
Scarface	Al Pacino, MIchelle Pfeiffer	Oliver Stone	Spanish Drug Lords, drama
Scarlett Letter	Demi Moore, Robert Duvall		Puritans, 1600, drama
Scent of a Woman	Al Pacino, Chris O'Donnell		Drama, Handicapped person
Schindler's List		Steven Spielberg	The Holocaust
Schtick	Burt Reynolds		Action
Score	Robert De Niro, Ed Norton, Marlon Brando, Angela Bassett	Frank Oz	Safecrackers
Scorpio			Action
Sea of Love	Al Pacino, Ellen Barken		Drama, homicide and romance
Searchers	John Wayne, Natalie Wood		Western
Seargent Bilko	Steve Martin, Max Casala		Comedy, Army
Secret of My Success	Michael J. Fox		Comedy, Business World
Seems Like Old Times	Goldie Hawn	Neil Simon	Comedy, Law
Senseless	David Spade		Comedy, 5 senses magnified
Sentinel	Keifer Sutherland, Michael Douglas, Kim Basinger, Eva Longoria		Drama, Secret Service
September Dawn	Trent Lott, Tamara Hope, Jon Voight	Christopher Cain	Western
Serpent's Eggs			Drama, AntiSemitism
Serpico	Al Pacino		Drama, Police corruption
Seven Faces of Dr. Lao	Tony Randall, Barbara Eden		Sci Fi Fantasy Western
Seventies	Guy Torry, Vanessa Shaw, Amy Smart, Brad Rowe		Drama, Sign of the Times: 70's
Sex and The Single Parent			Romance, kids
Shadow	Alec Baldwin		Comic Strip, 40's
Shampoo	Warren Beatty, Lee Grant, Goldie Hawn		Drama, swinger
Shamus	Burt Reynolds		Action, cops
Sharkey's Machine	Burt Reynolds		Action, cops
She Wore a Yellow Ribbon	John Wayne, Harry Carey Jr., Ben Johnson	John Ford	Western
Shergar -- Discover the Heart of a Champion	Mickey Rourke, Ian Holm, David Warner		Drama, Horsenapping & the IRA
Sherlock Holmes	Robert Downey Jr., Jude Law, Rachel MacAdams		Sherlock Holmes
Sherlock Holmes Smarter Brother	Gene Wilder		Comedy
She's So Lovely	John Travolta, Sean Penn		Drama, Romance, Mental Illness
Shootist	John Wayne		Western
Short Circuit	Steve Guttenburg, Ally Sheedy		Comedy, Robots
Shot in The Dark	Peter Sellers		Comedy, Inspector Clouseau
Showtime	Robert De Niro, Eddie Murphy, Renee Russo, William Shatner	Will Smith (Producer)	Cop Drama/Comedy/Hollywood
Shrek	Mike Myers, Cameon Diaz, Eddie Murphy, John Lithgow		Cartoon
Shrek 2	Eddie Murphy, John Cleese, Cameron Diaz, Antonio Banderas, Mike Myers		Cartoon
Shutter Island	Leonardo DiCaprio, Mark Ruffalo, Max Von Sydow	Martin Scorcese	Drama, Mental Institution
Sicko		Michael Moore	Documentary, US HealthCare
Sideways	Paul Giamati, Sandra Oh, Virginia Madsen		Drama, Calif wineries and affairs
Signs	Mel Gibson		Sci Fi
Silence of The Lambs	Jodie Foster, Anthony Hopkins		Psychopathic killers
Silent Movie	Mel Brooks, Dom Deluise, Burt Reynolds, Marty Feldman, Marcel Marceau	Mel Brooks	Comedy
Silent Partner	Elliot Gould, Christopher Plummer, John Candy, Suzannah York		Drama, Bank Robbery
Silent Running			Sci Fi
Silkwood	Meryl Streep, Kurt Russell, Cher		Drama, Radiation
Silver Streak	Richard Pryor, Jill Clayburgh, Gene Wilder		Comedy, trains
Silverado	Kevin Kline, Brian Dennehy, Jeff Goldblum		Western
Sin City	Mickey Rourke, Bruce Willis, Brittany Murphy, Clive Owen	Robert Rodriguez, Quentin Tarantino	Comic Book
Singing in The Rain	Gene Kelly, Debbie Reynolds, Donald O'Connor	Gene Kelly	Musical
Sixth Day	Arnold Shwarzeneggar, Robert Duvall, Tony Goldwyn, MIchael Rappaport		
Sixth Sense	Bruce Willis, Osman Haley		Horror
Skyjacked			Hijacking
Slap Shot 2	Stephen Baldwin, Gary Busey		Comedy, Ice Hockey
Slap Shot 3	Leslie Nielson, Steve Carlson, Jeff Carlson, Dave Hanson, Mark Messier, Doug Gilmour		Comedy, old time hockey
Slapshot	Paul Newma, Michael Ontkean, Hanson Bros.		Comedy, hockey
Sleeper	Woody Allen, Diane Keaton	Woody Allen	Sci Fi, comedy
Sleepers	Jason Patric, Brad Pitt, Kevin Bacon, Minnie Driver, Robert De Niro, Dustin Hoffman	Barry Levinson	Drama, Boys home sexual abuse
Sleeping With The Enemy	Julia Roberts		Drama, Abusive husband
Sleepless in Seattle	Meg Ryan, Tom Hanks	Nora Ephron	Romantic comedy
Sleuth	Michael Caine		Detective story
Small One			Animation
Small Time Crooks	Woody Allen, Tracy Ullman, John Lovitz, Hugh Grant	Woody Allen	Comedy, crooks & entrepreneurs
Smile	Bruce Dern		Drama, Beauty pageant
Smokey and the Bandit	Burt Reynolds, Sally Fields		Crooks, car chases
Smokey and The Bandit, Part II	Burt Reynolds, Sally Field, Jackie Gleason, Paul Williams, Jerry Reed, Terry Bradshaw, Mean Joe Green		Comedy
Smokin' Aces	Alicia Keys, Ray Liotta, Ben Affleck, Andy Garcia		Comic Book, Gangsters and FBI
Snatch	Brad Pitt, Vinnie Jones, Bernico De Moya, Dennis Farina		Gangsters: British, Russian, American Jewish, British Black
Sneakers	Robert Redford		Computer Criminals, Drama
Snoopy Come Home		Charles M. Schulz	Cartoon
Snow Falling on Cedars	Ethan Hawke		Law Drama, Murder/Japanese Prejudice
Snow Queen			Cartoon
Soapdish			Comedy, Soap Operas
Social Network	Jesse Eisenberg		Legal Drama, founder of Facebook
Soldier's Story			Drama, Military investigation
Some Like It Hot	Tony Curtis, Jack Lemmon		Comedy, CrossDressing
Something About Amelia	Ted Danson, Glenn Close		Drama, Child Molestation
Something Wild	Jeff Daniels, Melanie Griffith		Romantic comedy
Somethings Gotta Give	Jack Nicholson, Keeanu Reeves, Frances MacDormand, Diane Keaton, Amanda Peete		Romantic comedy
Somewhere in Time	Christopher Reeve, Jane Seymour		Romantic Drama, Mackinaw Island Grand Hotel
Son of Flubber	Fred McMurray		Disney Comedy
Sound of Music			Drama, Musical family
South Pacific			Musical, WWII
Soylent Green	Charleton Heston, Edward G. Robinson		Sci Fi
Space Cowboys	Clint Eastwood, Tommy Lee Jones, Donald Sutherland, James Garner	Clint Eastwood	Sci Fi
Space Hunter			Sci Fi, 3D
Spaceballs		Mel Brooks	Comedy, Sci Fi
Spartacus	Kirk Douglas		Roman Gladiators
Specialist	Sylvestor Stallone, Sharon Stone		Drama, Professional Killer
Speed	Keeanu Reeves, Sandra Bullock		Action
Spiderman	Tobey McGuire, Kurstin Dunst, William DaFoe, Cliff Robertson		Comic Book
Spiderman II	Tobey McGuire, Kirsten Dunst		Comic Book
Spike's Gang	Harry Morgan		Western
Spirit of St. Louis	James Stewart		Lindbergh NY to Paris flight
Splash	Tom Hanks, Darryl Hannah, John Candy		Comedy, romance, mermaid
Spy Game	Robert Redford, Brad Pitt	Tony Scott	Drama, CIA
Spy Who Loved Me	Roger Moore, Barbara Bach	Broccoli & Saltzman	James Bond
Spy Who Shagged Me	Mike Myers, Heather Graham, Rob Lowe, Elizabeth Hurley	Jay Stark, Demi Moore (Producer)	Comedy, Austin Powers
St. Elmo's Fire	Rob Lowe, Judd Nelson, Andrew McCarthy, Emilio Estevez, Demi Moore, Ally Sheedy, Mere Winningham		Drama, friendships/hardships
St. Ives	Charles Bronson		Action
St. Valentine's Day Massacre			Gangsters
Stage Coach (1938)			Western
Stage Coach (1965)			Western
Stakeout	Emilio Estevez, Richard Dreyfuss		Police Drama
Star Trek I	William Shatner, Leonard Nimoy, Deforest Kelly, Nichelle Nichols, James Doohan, George Takei		Sci Fi
Star Trek II: The Wrath of Kahn	William Shatner, Leonard Nimoy, Deforest Kelly, Nichelle Nichols, James Doohan, George Takei, Ricardo Montalban		Sci Fi
Star Trek III	William Shatner, Leonard Nimoy, Deforest Kelly, Nichelle Nichols, James Doohan, George Takei		Sci Fi
Star Trek IV	William Shatner, Leonard Nimoy, Deforest Kelly, Nichelle Nichols, James Doohan, George Takei		Sci Fi
Star Trek IX:  Insurrection	Patrick Stewart, Jonathon Frakes, Gates McFadden, Mirina Sirtis, Brent Spiner, Donna Martin, F Murray Abraham, Michael Dorn	Jonathon Frakes	Sci Fi
Star Trek Nemesis	Patrick Stewart, Jonathon Frakes, Gates McFadden, Marina Sirtis, Brent Spiner, Lavar Burton		Sci Fi
Star Trek VI: The Undiscovered Country	William Shatner, Leonard Nimoy, Deforest Kelly, Nichelle Nichols, James Doohan, George Takei		Sci Fi
Star Trek VII:  Generations	William Shatner, James Doohan, Patrick Stewart, Marina Sirtis, Gates McFadden, LeVar Burton, Brent Spiner		Sci Fi
Star Trek VIII:  First Contact	Patrick Stewart, Marina Sirtis, Gates McFadden, LeVar Burton, Brent Spiner		Sci Fi
Star Wars	Carrie Fisher, Harrison Ford, Mark Hamill	George Lucas	Sci Fi
Stardust Memories	Woody Allen	Woody Allen	Drama
Stargate	Kurt Russell, James Spader		Sci Fi
Starman	Jeff Bridges, Karen Allen		Sci Fi
Starsky and Hutch	Ben Stiller, Owen Wilson		Comedy, Police
State of Play	Ben Affleck, Russell Crowe, Jeff Daniels, Rachel MacAdam, Robin Wright Penn		Political Thriller
Stepford Wives	Katherine Ross		Sci Fi, robots
Still of The Night			
Still Smokin'	Cheech and Chong	Tommy Chong	Comedy, Amsterdam
Sting	Robert Redford, Paul Newman, Robert Shaw		1930's conmen
Stomp The Yard			Black Romantic Drama, Dance Competitions
Storyville			
Stranger in the Mirror		Sydney Sheldon Novel	Romantic Drama
Strike Force			Action, Cops
Stripes	Bill Murray, John Candy		Comedy, army
StripTease	Demi Moore		Drama, Strippers
Sudden Impact	Clint Eastwood, Sondra Locke		Dirty Harry, Vigilante cop
Sugarland Express	Goldie Hawn, Ben Johnson, William Atherton	Steven Spielberg	Prison Escape
Suicide Kings	Christopher Walken, Jay Mohr, Henry Thomas, Jay Gilicki, Denis Leary		Dark Comedy, kidnapping
Summer of '42			Romantic Drama
Summer of Sam	Mira Sirvino, Spike Lee, Jennifer Epstein, Ben Kingsley	Spike Lee	Drama, Son of Sam
Summer Rental	John Candy		Comedy, Sailing
Sunshine Boys	Walter Matthau, George Burns		Comedy, old men and plays
Superman	Christoper Reeves, Margot Kidder, Rex Reed, Gene Hackman		Comic Book
Superman II	Christoper Reeves, Margot Kidder, Marlon Brando, Gene Hackman		Comic Book
Support Your Local Gunfighter			Western
Suspect Zero	Aaron Eckhert, Ben Kingsley		Drama, FBI & Serial Killers
Sweet Hearts Dance	Don Johnson, Jeff Daniels, Susan Sarandon,Elizabeth Perkins, Kate Reid		Romantic Drama
Sweet Home Alabama	Reese Witherspoon, Mary Kay Place, Candice Bergen		Romantic comedy
SweetWater			Drama, Sweetwater band that opened Woodstock
Switch	Jennifer Aniston, Jason Bateman, Jeff Goldblum		Romantic Comedy, Sperm Donor
Syriana	Matt Damon, George Clooney, Christopher Plummer, William Hurt, Amanda Peet	George Clooney, Steven Soderberg (Producers)	Drama, Terrorism and Oil Profits
Take The Money & Run	Woody Allen	Woody Allen	Comedy
Taken	Liam Neeson		Drama, Sex Slavery
Takers	Matt Dillon, Chris Brown		Drama, Bank Robbers and Cops
Talented Mr. Ripley	Matt Damon, Gwyneth Paltrow, Jude Law		Drama, Italy, Rich people, murder
Talk Radio	Alec Baldwin	Oliver Stone	Drama, Radio show
Tango And Cash	Kurt Russell		Action, cops
Taps	Tom Cruise, Sean Penn, Timothy Hutton, George C. Scott		Drama, military school
Tarzan	Tony Goodwyn, Minnie Driver, Glenn Close	Walt Disney	Cartoon
Tatooed Dragon			
Taxi Driver	Robert De Niro, Jodie Foster		Drama, NYC loneliness
Team America: World Police	Trey Parker, Matt Stone	Parker & Stone	Puppets, terrorist comedy
Tecumseh	222	Francis Ford Coppola	Western
Teen Wolf	Michael J. Fox		Comedy, Hi School basketball
Telefon	Charles Bronson		Mystery, Spies
Ten	Bo Derek, Dudley Moore	Blake Edwards	Romantic comedy
Ten Little Indians		Agatha Christie	Murder Mystery
Terminal Bliss	Luke Perry		Drama
Terminal Velocity	Natashia Kinski		Action
Termination Point	Lou Diamond Phillips, Jason Priestly		SciFi
Terminator	Arnold Shwarzenegger, Linda Hamilton		Sci Fi
Terminator 3	Arnold Shwarzeneggar, Claire Danes		Sci Fi
Terminator II	Arnold Shwarzenegger, Linda Hamilton		Sci Fi
Terror in the Sky			Airplane drama
Texas Chainsaw Massacre (1974)			Horror
Thank You For Smoking	Sam Elliot, Aaron Eckhart, Rob Lowe, Robert Duvall, William H Macy, Katie Holmes		Comedy, tobacco spokesman
The Crew	Richard Dreyfuss, Burt Reynolds, Seymour Cassel, Dan Hedaya, Carrie Anne Moss, Jennifer Tilly		Comedy, retired mafiosi
Thelma & Louise	Susan Sarandon, Geena Davis, Harvey Keitel		Drama, Fugitive Criminals
There's Something About Mary	Ben Stiller, Cameron Diaz, Matt Dillon, Brett Favre		Comedy
Thief Of Hearts			Romantic Drama
Thief Who Came To Dinner	Ryan O'Neal, Jacqueline Bassett		Safecracking
Thirteen Conversations	Alan Arkin, Amy Irving, Matthew McConaury		Drama:  People's Lives
Thirteen Days	Kevin Costner		Cuban Missile Crisis
This is my Alaska			Alaska
Thomas Crowne Affair	Pierce Brosnan, Rene Russo, Denis Leary, Ben Gazarra		Drama, romance, billionaire art thief
Three Days of The Condor	Robert Redford, Faye Dunaway, Cliff Robertson, Max Von Sydow	Dino DiLaurentis, Sydney Pollock	Espionage
Three For The Money			
Three Fugitives	Martin Short, Nick Nolte		Comedy
Three Men and a Baby	Steve Guttenberg, Tom Selleck, Ted Danson		Comedy
Three Musketeers			Adventure
Three Stooges Meet Hercules	Three Stooges		Comedy
Thunder Road	Robert Mitchum		Fast Cars, Bootlegging
Thunderball	Sean Connery	Broccoli & Saltzman	James Bond
Thunderbolt and Lightfoot	Clint Eastwood, Jeff Bridges, George Kennedy, 		Bank Robbers
Tightrope	Clint Eastwood		Mystery
Time After Time	Mary Steenburgen		Sci Fi
Time Bandits			Sci Fi
Time Machine		H G Wells	Sci Fi
Time Rider			Sci Fi, Western
Time to Kill	Sandra Bullock, Ashley Judd, Donald Sutherland, Keifer Sutherland, Kevin Spacey, Samuel Jackson, Oliver Platt	John Grisham	Legal Drama
Time Traveler's Wife	Rachel McAdam		Romantic Drama, Time Travel
Tin Cup	Kevin Costner, Rene Russo, Don Johnson, Cheech Marin		Romantic comedy, Golf
Tin Men	Danny DeVito, Richard Dreyfuss, Barbara Hershey, Bruno Kirby, Michael Tucker	Barry Levinson	Con Men
Titanic	Leonardo DeCaprio, Kate Winslett		Drama, Romance, Oceanliner disaster
To Be Or Not To Be	Mel Brooks	Mel Brooks	Comedy, Theatre
To Catch a King	Robert Wagner, Teri Garr		Drama, WWII kidnapping
To Sir With Love	Sydney Poitier		School drama, romance
Toklat			Bears in nature
Tombstone	Jason Priestly, Val Kilmer		Western
Tomorrow Never Dies	Pierce Broznan, Joe Don Baker, Jonathon Pryce, Teri Hatcher, Judi Dench, Desmond Llewellan	Albert Broccoli	James Bond
Tootsie	Dustin Hoffman, Jessica Lange, Bill Murray, Charles Durning		Comedy, Acting in soaps
Top Gun	Tom Cruise, Kelly McGillis		Action, Fighter pilots
Total Recall	Arnold Shwarzenegger		Sci Fi
Touch of Evil	Orson Welles, Janet Leigh	Orson Welles	Drama, detective/thugs
Tower Heist	Eddie Murphy, Ben Stiller, Casey Affleck, Alan Alda, Matthew Broderick, Tea Leoni		Comedy, thiefs
Towering Inferno			Disaster action
Town	Ben Affleck		Drama, Professional Robbers
Toy Story 3	Tom Hanks, Joan Cusack, Michael Keaton		Animation
TR Baskin	Candice Bergen		Drama, loneliness, office work
Traces of Red			Drama
Trading Places	Eddie Murphy, Dan Aykroyd, Jamie Lee Curtis, Ralph Bellamy, Don Ameche, Jim Belushi, Bo Diddley	John Landis	Comedy, Finance
Traffic	Michael Douglas, Catherine Zeta Jones, Benico Del Toro	Steven Soderbergh	Drama, Drugs
Trail of The Pink Panther	Peter Sellers		Comedy
Train Robbers	John Wayne, Anne Margret, Ben Johnson, Rod Taylor, Ricardo Montalban		Western
Treasure of The Sierra Madre			Western
Triple Cross			Spies, Drama
Tropical Thunder	Ben Stiller, Robert Downey Jr., Tom Cruise	Ben Stiller	Comedy, Vietnam movie making
True Grit	John Wayne		Western
True Romance	Christian Slater, Patricia Arquette, Val Kilmer, Brad Pitt, Christoper Walken, Chris Penn, Samuel L. Jackson, Dennis Hopper, Saul Rubiken, James Gandolfina	Quentin Tarantino, Tony Scott	Romantic Drama and Gangsters
Truman Show	Jim Carey, Ed Harris		Drama, Twilight Zone Psychology
Tucker	Jeff Bridges		Automobile Entrepreneur, Drama
Turbulence	Ray Liotta		Drama, Criminals on a Airplane
Twelve Chairs	Zero Mostel	Mel Brooks	Comedy
Twelve Monkeys	Bruce Willis		Sci Fi
Twilight Zone	Vic Morrow, Scatman Crothers, John Lithgow	Steven Spielberg, John Landis	Sci Fi
Two Flags West			
Two for the Money	Al Pacino, Matthew McConnaughey, Renee Russo		Drama, Gambling
Two Minute Warning	Jack Klugman		Football, Psychopathic killer
Two Mules For Sister Sara	Clint Eastwood, Shirley MacLean	Don Siegel	Western
Two of a Kind	John Travolta, Olivia Newton John		
UlZana's Raid			Western
Uncle Buck	John Candy		Comedy
Undefeated			
Unfaithful	Richard Gere, Diane Lane, Olivera Martinez	Adrian Lyne	Romantic Drama
Unforgiven	Clint Eastwood		Western
Unknown	Liam Neeson, Aidan Quinn		Drama, Scientist/Amnesia/Germany
Untouchables	Kevin Costner, Andy Garcia, Sean Connery,Charles Martin Smith, Robert De Niro	Brian De Palmo	Chicago Ganster Al Capone
Up	Christopher Plummer, Ed Asnor		Animation, flying house
Up Close and Personal	Michelle Pfeiffer, Robert Redford		Drama, romance, reporters
Up In Smoke	Cheech & Chong, Stacy Keach, Madeline Kahn		Comedy, Marijuana
Uptown Saturday Night	Richard Pryor		Comedy
Usual Suspects	Kevin Spacey, Benico Del Toro	Bryan Singer	Crime Drama
Vacation	Chevy Chase		Comedy
Valkyrie	Tom Cruise, Tom Wilkinson	Bryan Singer	Drama, Hitler Assasination Plot
Vanilla Sky	Tom Cruise, Penelope Cruz, Cameron Diaz, Kurt Russell		Drama, Car Accident/Dreams
Vantage Point	Forrest Whitaker, Harrison Ford, Dennis Quaid, Sigourney Weaver		Drama, Presidential Assasination
Varsity Blues	Jon Voight		Drama, Football
Venetian Affair			
Vertigo		Alfred Hitchcock	Drama
Vice Versa			
Victory	Sylvester Stallone, Michael Caine		Drama, Soccer
Videodrome	James Woods, Blondie		Horror, Sci Fi
View From The Top	Gwyneth Paltrow, Christine Applegate, Kelly Preston, Candice Bergen, MIke Myers, Rob Lowe		Comedy
View to a Kill	Roger Moore, Tanya Roberts, Grace Jones, Christopher Walkan	Albert R. Broccoli	James Bond
Villain	Arnold Shwarzenegger, Gene Wilder		Comedy, Western
W.W. and The Dixie Dancekings	Burt Reynolds		Music, thieves
Wait Until Dark	Alan Arkin		Horror
Waiting for Guffman	Eugene Levy, Christopher Guest, Harry Scherer		Comedy, Small town no-talents
Waiting For Superman			Documentary, American Educational System
Walk The Line	Joaquin Phoenix, Reese Witherspoon		Drama, Johnny Cash Story
Wall Street	Charlie Sheen, Michael Douglas, Sean Young, Darryl Hannah, Hal Holbrook, Terence Stamp, Richard Dysart, James Spader, Martin Sheen	Oliver Stone	Drama, Insider Trading
Wall Street:  Money Never Sleeps	Michael Douglas, Charlie Sheen, Kerry Mulligan		Drama, Wall Street crooks
Wanted	Angelina Jolie, Morgan Freeman		Action, Assasins
War Games	Matthew Broderick		Drama, Hacker, Nuclear War
War Horse		Steven Spielberg	WW1 Drama
War of The Worlds		H. G. Wells	Sci Fi
War Wagon			Western
Wayne's World	Mike Myers, Dana Carvey, Rob Lowe		Comedy, Sat Night Live
Waynes World II	Dana Carvey, Mike Myers		Comedy
We own the Night	Mark Wahlberg, Joaquin Phoenix, Robert Duvall, Eva Mondez		Russian MAFIA, NYPD
Weatherman	Nicholas Cage, Michael Caine		Romantic Drama, troubled kids
Weekend At Bernies	Andrew McCarthy		Comedy
Weird Science	Anthony Michael Hall, Kelly LeBrock		Comedy
West Side Story			Musical, Drama
Westerner	Gary Cooper		Western
Westworld	James Coburn, Richard Benjamin, Yul Brynner		Sci Fi
What's New Pussycat	Woody Allen		Comedy
What's Up Doc	Ryan O'Neal, Barbara Streisand		Comedy
What's Up Tiger Lily	Woody Allen		Comedy
When a Man Loves a Woman	Meg Ryan, Andy Garcia		Romantic Drama
When do we Eat	Jack Klugman		Comedy, Passover Sedar
When Harry Met Sally	Meg Ryan, Billy Crystal, Carrie Fisher	Nora Ephron	Romantic Comedy
When the Levees Broke		Spike Lee	Documentary, hurricane Katrina
When Worlds Collide			Sci Fi
Where Eagles Dare	Clint Eastwood	Alistair MacLean	WWII, Espionage
Where The Boys Are	Yvette Memieux		Comedy, Beach Parties
Where were you when the Lights Went Out	Richard Benjamin		Comedy
While You Were Sleeping	Sandra Bullock, Bill Pullman		Romantic Comedy
White Buffalo	Charles Bronson, Slim Pickens		Western
Who Framed Roger Rabbit	Katherine Ross, Christopher Lloyd	Steven Spielberg	Animation
Who Killed the Electric Car	Phyllis Diller, Martin Sheen, Mel Gibson		Documentary
Whole Nine Yards	Bruce Willis, Matthew Perry, Rosanna Arquette, Michael Clarke Duncan		Comedy, Hit Man
Whole Ten Yards	Bruce Willis, Matthew Perry, Amanda Peet		Romantic Comedy, Mafia
Who'll Stop The Rain	NIck Nolte, Tuesday Weld, Michael Moriarty, Ray Starkey		Drama, Drugs
Whore	Theresa Russell		Drama
Who's Invited to Dinner			
Why did I get Married	Tyler Perry, Janet Jackson	Tyler Perry	Comedy/Drama Marriage Problems
Wilby Conspiracy	Michael Caine		African Adventure
Wild Bill			Westerm, wild Bill Hickock
Wild Life	Bill Pullman, Melanie Griffith		Comedy, Romance
Wind	Matthew Modine		Drama, Sailing
Wisdom			
Witches of Eastwick	Jack Nicholson, Michelle Pfeiffer, Susan Sarandon, Cher		Comedy
With Six You Get Eggroll			Comedy, Family Life
Without a Clue			
Witless Protection	Larry the Cable Guy, Ivana Delisovich, Jenny McCarthy, Joe Montegna, Yaphet Kotto		Comedy
Witness	Harrison Ford		Drama, Amish Murder Mystery
Wizard of Oz	Judy Garland		Animation
Wizards			Animation
Woman in Red	Kelly LeBrock, Gene Wilder, Gilda Radner		Comedy
Woman, a Gun and a Noodle Shop			Chinese Adventure
Wonder Boys	Michael Douglas, Robert Downey Jr., Tobey McGuire, Francis McDormand, Richard Thomas		Drama, College kids and weird people
Wonderland	Val Kilmer, Kate Bosworth, Christine Applegate, Carrie Fisher, Eric Bregosian, Lisa Kudrow		Drama, Porn King Johnny Holmes
WoodStock			Music
Working Girl	Melanie Griffith, Alec Baldwin, Kevin Spacey		Comedy
World is not Enough	Pierce Brosnan, Denise Richards, John Cleese, Sophie Marceau, Robert Carlyle, Robbie Coltrane, Judi Dench	Michael Apted, Ian Fleming, Albert R. Broccoli	James Bond
World's Greatest Athlete			Comedy, Disney
Worth Winning	Mark Hamill		Romantic Comedy
Wyatt Earp	Kevin Costner, Dennis Hopper, Jo Beth Williams, Mere Winningham		Western
XFiles	David Duchovney, Gillian Anderson		Sci Fi
XFiles -- I want to Believe	David Ducovney, Gillian Anderson, Amanda Peete	Chris Carter	SciFi
Yakuza	Robert Mitchum, Brian Keith	Sydney Pollock	Drama, Japanese Mafia
Year of The Dragon	MIckey Rourke	Dino Di Laurentis, Michael Cimino, Oliver Stone	Chinese Mafia
Year of The Gun	Andrew McCarthy		Drama, Europe
Yellow Submarine	The Beatles		
Yes Man	Jim Carrey		Romantic Comedy, Cult
You Will Meet a Tall Dark Stranger	Anthony Hopkins, Josh Brolin, Naomi Watts, Antonio Banderas	Woody Allen	Romantic Drama
Young Frankenstein	Marty Feldman, Dom Deluise	Mel Brooks	Comedy
Young Guns	Emilio Estevez, Charlie Sheen, Keifer Sutherland, Lou Diamond Phillips, Dermot Mulroney, Jack Palance		Western
Young Guns II	Emilio Estevez, Lou Diamond Phillips, Keifer Sutherland, Christian Slater		Western
Young Guns II	Emilio Estevez, Keifer Sutherland, Christian Slater, Lou Diamond Phillips, Alan Ruck, William Petersen, James Colburn, Tracy Walker		Western, Billy The Kidd
Young Sherlock Holmes			
YoungBlood	Rob Lowe, Patrick Swayze		Drama, Ice Hockey
You've Got Mail	Meg Ryan, Tom Hanks, Jean Stapleton	Nora Ephron	Romantic comedy
Zardoz	Sean Connery		Sci Fi
Zebrahead		Oliver Stone	Romantic Drama, Detroit
Zelig	Woody Allen, Mia Farrow	Woody Allen	Comedy, Human Chameleon Documentary
Zoolander	Ben Stiller, Owen Wilson, Will Ferrell, Wynona Ryder, Christine Taylor, Jon Voight, Gerry Stiller, David Duchuvny	Ben Stiller	Comedy, Male Models
